Title,Release date,Time Period,Start Time,End Time,Diff,Notes on setting,Location
The Clan of the Cave Bear,1986,"40,000 - 35,000 BC",-40000,-40000,0,In times of Neanderthal extinction,Europe
The Rising Sea,1953,1848-49,1848,1849,1,"Epic Hungarian movie in Communist style about the 1848–49 Revolution and War of Freedom in Hungary, and about the great Hungarian poet Sándor Pet?fi. Known with the title: Föltámadott a tenger",Hungary
Men and Banners,1965,1848-49,1848,1849,1,Epic Hungarian movie about the 1848–49 Revolution and War of Freedom in Hungary. Known with the title A k?szív? ember fiai,Hungary
The Opium War,1997,1839-42,1839,1842,3,"historical epic film about the First Opium War, told through the eyes of Lin Zexu and Charles Elliot",China
The Sound of a Flower,2015,1867-84,1867,1884,17,About the life of the Korean pansori singer Shin Jae-hyo.,Korea
Chi-hwa-seon,2002,1843-97,1843,1897,54,About the life of Korean painter Oh-won.,Korea
War of the Arrows,2011,1636-7,1636,1636,0,Set during the second Manchu invasion of Korea.,Korea
Mohenjo Daro,2016,2500 - 2000 BC,-2500,-2500,0,"Fictional story set in Mohenjo-daro, a city of the Bronze Age Indus Valley Civilization.",Mohenjo-daro
Sansho the Bailiff,1954,794-1185,1050,1050,0,Awards: 1 Silver Lion,Japan
Fall of Ming,2013,1368-1644,1642,1644,2,,China
Brotherhood of Blades,2014,1368-1644,1642,1644,2,,China
The Cleopatras,1983,305-30 BC,-305,-30,275,Egypt – The entire Ptolemaic dynasty,Egypt
Bloody Spear at Mount Fuji,1955,1603-1868,1603,1868,265,Awards: 1 Blue Ribbon Award,Japan
Yagy? Ren'yasai: Hidentsuki Kagesh?,1956,1603-1868,1603,1868,265,,Japan
Ancient Rome: The Rise and Fall of an Empire,2006,146 BC-410 AD,-146,-410,264,From Tiberius Gracchus to the Sack of Rome (410). BBC Docu-drama.,Rome
Little Big Soldier,2010,475-221 BC,-475,-221,254,"an action-comedy film set in the Warring States period, about a war between the Liang and Wey states",China
Barbarians Rising,2016,218 BC-455 AD,-218,-455,237,From the Second Punic War to the Sack of Rome (455). History channel Docu-drama.,Rome
The Scorpion King,2002,3200-3000 BC,-3200,-3200,0,"A fantasy action film based on historical king of the Protodynastic Period of Egypt, King Scorpion.",Egypt
Mulan Joins the Army,1939,ca. 567-571,386,534,148,based on the legend of Hua Mulan,China
Mulan,2009,ca. 386-534,386,534,148,based on the legend of Hua Mulan,China
Amaya,2010,1400-1521,1400,1521,121,The film depicting the Philippines during the Classical Period.,Philippines
Banaue: Stairway to the Sky,1974,c. 500 BC.,-500,-500,0,"The film depicts the Prehistory of the Philippines, and the construction of the Banaue Rice Terraces.",Philippines
Roman Empire,2016,81 BC-192 AD,-81,-192,111,"Anthology docudrama series based on events in Rome, highlighting dictator Julius Caesar, and the emperors Caligula and Commodus",Rome
Ermak,1996,1580-1690,1580,1690,110,Yermak Timofeyevich and the Russian conquest of Siberia.,Siberia
Robinson Crusoe,1997,1694-early 1800 ,1694,1800,106,Robinson Crusoe flees Britain on a ship after killing his friend over love for the same woman. A fierce ocean storm wrecks his ship and leaves him stranded by himself on an uncharted island where he must fight for survival.,England
St. Patrick: The Irish Legend,2000,387-493,387,493,106,Ireland and Roman Britain during the life of Saint Patrick,Ireland
Abraham,1993,2100-2000 BC,-2100,-2000,100,A television film based on the life of the patriarch Abraham.,Israel
Dirili?: Ertu?rul,2014,early-to-late 1300 ,1300,1400,100,"13th century Turkish warrior Ertu?rul agrees to fight the enemies of Seljuk Sultan Ala ad-Din Kay Qubadh I in exchange for land when a good deed endangers his clan. It centers around the life of Ertu?rul, the father of Osman I, who was the founder of the Ottoman Empire",Anatolia
Marakkar: Lion of the Arabian Sea,2021,1505 - 1601,1505,1601,96,"Based on the battle exploits and resistance of Kunjali Marakkar IV, the naval commander of the Samoothiri of Calicut, against Portuguese invasion along the Malabar Coast for establishing monopoly of trade in the Indian subcontinent.",India
The Hollow Crown,2012,1398-1485,1398,1485,87,"series of films based on Shakespeare's plays depicting the lives of Richard II of England, Henry IV of England, Henry V of England, Henry VI of England, and Richard III of England",England
Solomon and Sheba,1959,1011-931 BC,-1011,-931,80,"Set in the Southern Beirut, Lebanon, during the reign of Solomon, Kings of Israel. Solomon forms a political alliance with the Queen of Sheba, becomes a lover of his new ally, and introduces pagan rituals in his kingdom. His exiled half-brother Adonijah offers his military services to Ancient Egypt and leads an Egyptian army in an invasion of Kingdom of Israel. The events of the film are loosely based on narratives from the Books of Kings and the Books of Chronicles. The Books of Kings depict Adonijah and Solomon as sons of David and rival claimants to the throne of Israel, but do not feature Adonijah as loyal to Egypt. Instead, Solomon himself is traditionally depicted as an ally of Egypt and as husband of a Pharaoh's daughter.",Israel
Siddhartha,1972,563/480 - 483/400 BC,-563,-483,80,About the life of a boy and his search for a meaningful way of life,Kapilavastu
Gautama Buddha,2007,563/480 - 483/400 BC,-563,-483,80,About the life of Gautama Buddha,Kapilavastu
The Ten Commandments,1956,1290-1213 BC,-1290,-1213,77,"Set in Ancient Egypt, during the reign of Ramesses II, a member of the Nineteenth Dynasty of Egypt. The film is based on the founding narrative of the Exodus, as depicted in the books of Exodus, Leviticus, Numbers, and Deuteronomy.",Egypt
The Prince of Egypt,1998,1290-1213 BC,-1290,-1213,77,"Set in Ancient Egypt, during the reign of Ramesses II, a member of the Nineteenth Dynasty of Egypt. The film is based on the founding narrative of the Exodus, as depicted in the books of Exodus, Leviticus, Numbers, and Deuteronomy.",Egypt
Exodus: Gods and Kings,2014,1290-1213 BC,-1290,-1213,77,"Set in Ancient Egypt, during the reign of Ramesses II, a member of the Nineteenth Dynasty of Egypt. The film is based on the founding narrative of the Exodus, as depicted in the books of Exodus, Leviticus, Numbers, and Deuteronomy.",Egypt
Felix Manalo,2015,1886-1963,1886,1963,77,"The life of Felix Manalo, founder and pioneer executive minister of the Iglesia ni Cristo, which spans from his early life up to the end of his life on April 12, 1963, including the atrocities committed by Japan during World War 2.",Philippines
Augustine: The Decline of the Roman Empire,2010,354-430,354,430,76,"Roman province of Africa – focusing on the life of Augustine of Hippo, and including the Vandal conquest of Carthage",Rome
Indio,2011,1601-1677,1601,1677,76,An Epic Historical-fiction story about the Spanish Conquest and Philippine revolts against Spain.,Philippines
El Presidente,2012,1886-1962,1886,1962,76,"The life of the first president of the Philippines Emilio Aguinaldo which spans the Philippine Revolution, Philippine–American War, up to the full restoration of Philippine independence on July 4, 1946.",Philippines
The Empress Dowager,1975,1835-1908,1835,1908,73,a Hong Kong film about Empress Dowager Cixi,China
Confucius,1940,551-479 BC,-551,-479,72,"thought to be a lost film, but was rediscovered in 2001 and restored",China
The First Churchills,1969,1650-1722,1650,1722,72,"A BBC serial about the life of John Churchill, 1st Duke of Marlborough and his wife, Sarah Churchill, Duchess of Marlborough",England
Destiny,1997,1126-1198,1126,1198,72,"about Averroes, the 12th-century philosopher from Muslim-controlled Andalusia in Spain whose commentaries would become a staple for subsequent generations of students of Aristotle in Europe",Spain
Vikings,2013,793-865,793,865,72,"Series inspired by the sagas of Viking Ragnar Lothbrok, one of the best-known legendary Norse heroes and notorious as the scourge of England and France.",England
The Adventures of Marco Polo,1938,1254-1325,1254,1325,71,the Italian explorer who traveled to the court of Kublai Khan,China
Marco Polo,1962,1254-1325,1254,1325,71,the Italian explorer who traveled to the court of Kublai Khan,China
Marco the Magnificent,1965,1254-1325,1254,1325,71,the Italian explorer who traveled to the court of Kublai Khan,China
Marco,1973,1254-1325,1254,1325,71,the Italian explorer who traveled to the court of Kublai Khan,China
Marco Polo,1975,1254-1325,1254,1325,71,the Italian explorer who traveled to the court of Kublai Khan,China
Marco Polo,1982,1254-1325,1254,1325,71,the Italian explorer who traveled to the court of Kublai Khan,China
Marco Polo,2007,1254-1325,1254,1325,71,the Italian explorer who traveled to the court of Kublai Khan,China
Marco Polo,2014,1254-1325,1254,1325,71,the Italian explorer who traveled to the court of Kublai Khan,China
David and Bathsheba,1951,1040-970 BC,-1040,-970,70,"Set in the Southern Beirut, Lebanon, during the reign of David, Kings of Israel. David is married to Michal, daughter of his predecessor Saul. David has an extramarital affair with Bathsheba, wife of the soldier Uriah the Hittite. Uriah is one of David's Mighty Warriors (a group of soldiers personally loyal to David), but David arranges for Uriah to be killed in battle and then claims Bathsheba as his new wife. Based on the Books of Samuel.",Israel
A Story of David,1960,1040-970 BC,-1040,-970,70,"Set in the Southern Beirut, Lebanon, it depicts the complex relationship between Saul, Kings of Israel and his son-in-law and eventual successor David. Based on the Books of Samuel, where Saul is depicted as the founder of the Kingdom of Israel.",Israel
David and Goliath,1960,1040-970 BC,-1040,-970,70,"Set in the Southern Beirut, Lebanon, focused on the conflict between rival kings Saul and Asrod, and their representatives in champion warfare: David and Goliath of Gath. Based on the Books of Samuel, which depict Achish as a king of Gath who was in conflict with Saul and recruited David to serve in his army.",Israel
Andrei Rublev,1966,1360-1430,1360,1430,70,"about the life of Andrei Rublev, who was considered to be the greatest medieval Russian painter of icons and frescoes",Russia
Marco Polo,1982,1254-1324,1254,1324,70,an American-Italian television miniseries about the Venetian explorer who traveled to China and served in the court of Kublai Khan,China
King David,1985,1040-970 BC,-1040,-970,70,"Set in the Southern Beirut, Lebanon, it depicts the life and reign of David, Kings of Israel. Based on the Books of Samuel. David is the supposed founder of the House of David (Davidic line).",Israel
Aba,2008,437-367 BC,-437,-367,70,based on the historical legend of King Pandukabhaya,Sri Lanka
Tomyris,2019,600 - 530 BC,-600,-530,70,"The film is based on the story of Herodotus about the death of the Persian King Cyrus the Great during the war with Massagetae, which was commanded by the queen Tomiris.",Anshan
Citizen Kane,1941,1871-1940,1871,1940,69,Chronicles the life of fictional yellow journalist Charles Foster Kane.,New York
Edward the Seventh,1975,1841-1910,1841,1910,69,"The life of Edward VII, King of the United Kingdom of Great Britain and Ireland.",UK
Rajaraja Cholan,1973,947 - 1014,947,1014,67,About the life history of great king Raja Raja Chola,India
Aloko Udapadi,2017,103 BC and c. 89-77 BC,-342,-275,67,based on the odyssey of King King Valagamba,Sri Lanka
Ponniyin Selvan,2022,947 - 1014,947,1014,67,About the life history of great king Raja Raja Chola,India
The Cantor of St Thomas's,1984,1685-1750,1685,1750,65,German composer Johann Sebastian Bach,Germany
Li Lianying: The Imperial Eunuch,1991,1848-1911,1848,1911,63,the Qing Dynasty eunuch Li Lianying,China
"Gunpowder, Treason & Plot",2004,1542-1605,1542,1605,63,"The reigns of Mary, Queen of Scots and her son James I of England.",England
Jodhaa Akbar,2008,1542-1605,1542,1605,63,"The love story of Mughal emperor Akbar the Great and Rajput princess ""Jodhaa"" i.e. Empress Mariam uz-Zamani.",Agra
The Message,1976,570-632,570,632,62,Arabian Peninsula – the life of Muhammad,Mecca
The Devil's Crown,1978,1154-1216,1154,1216,62,"During the reigns of Henry II, Richard I and John",England
The Messenger of God,2015,570-632,570,632,62,Arabian Peninsula – the life of Muhammad,Mecca
Queen Mandukhai the Wise,1988,1449 - 1510,1449,1510,61,Mongolian language film about the life of Queen Mandukhai (1449–1510) who reunited the Mongols.,Mongolia
El Cid,1961,1040-1099,1040,1099,59,"Rodrigo Díaz de Vivar, an 11th-century Spanish warrior known as El Cid",Iberian Peninsula
El Cid,2020,1040-1099,1040,1099,59,"Rodrigo Díaz de Vivar, an 11th-century Spanish warrior known as El Cid",Iberian Peninsula
Louis van Beethoven,2020,1770-1827,1770,1827,57,"Life of Ludwig van Beethoven, called Louis in family",Bonn
Tsogt Taij,1945,1581-1637,1581,1637,56,Mongolian language film about the patriotic struggle of Prince Tsogt Taij (1581–1637).,Mongolia
Nostradamus,1994,1510-1566,1510,1566,56,The life story of Nostradamus.,France
Julius Caesar,2002,100-44 BC,-100,-44,56,"a bio-pic of Julius Caesar, not the Shakespeare play about his death and the aftermath",Rome
John Adams,2008,1770-1826,1770,1826,56,The story about the American Founding Father John Adams from the Boston massacre in 1770 to his death in 1826.[4],Boston
The Empress Wu Tse-tien,1939,650-705,650,705,55,based on the story of Wu Zetian,China
Le Roi danse,2000,1632-1687,1632,1687,55,"Jean-Baptiste Lully, an Italian immigrant to France and noted composer of Baroque music.",France
Agora,2009,360-415,360,415,55,Life and death of scientist/philosopher Hypatia of Alexandria and the destruction of the Library.,"alexandria, egypt"
Ivan Groznyy,2009,1530-1584,1530,1584,54,16-episodes TV Series about Ivan IV of Russia.,Russia
Tsar,2009,1530-1584,1530,1584,54,Film about Ivan IV of Russia.,Russia
Ivan the Terrible,1944,1530-1584,1530,1584,54,Two-part film about Ivan IV of Russia.,Russua
Immortal Admiral Yi Sun-sin,2004,1545-1598,1545,1598,53,Life of the Korean admiral Yi Sun-sin and the Japanese invasions of Korea (1592–1598),Korea
Napoleon (1955 film),1955,1769-1821,1769,1821,52,French historical epic film that depicts major events in the life of Napoleon.,France
Lapu-Lapu,1955,1491-1542,1491,1542,51,The life of Lapu-Lapu and death of Magellan.,Philippines
Molière,1978,1622-1673,1622,1673,51,The French playwright Molière,France
Slave of Dreams,1995,1901-1850 BC,-1901,-1850,51,"Set in Ancient Egypt and based on the story of Joseph, a Vizier depicted in the Book of Genesis. The era of the film's setting corresponds to the Twelfth Dynasty of Egypt.",Egypt
Joseph,1995,1901-1850 BC,-1901,-1850,51,"Set in Ancient Egypt and based on the story of Joseph, a Vizier depicted in the Book of Genesis. The era of the film's setting corresponds to the Twelfth Dynasty of Egypt.",Egypt
Lapu-Lapu,2002,1491-1542,1491,1542,51,A remake of the 1955 film that tells the life of Lapu-Lapu.,Philippines
The Black Rose,1950,mid-to-late 1300 ,1350,1400,50,"the fictional exploits of a young Englishman who travels to China, falls in love along the way, and manages to return with a formula for gunpowder",China
Ulysses,1954,1200-1150 BC,-1200,-1150,50,"Set in the aftermath of the Trojan War, based on the epic poem Odyssey by Homer. It depicts the ten-year struggle of war veteran Odysseus to return home to the island of Ithaca following the war.",Anatolia
Helen of Troy,1956,1200-1150 BC,-1200,-1150,50,"Set in western Anatolia during the Trojan War, largery based on the epic poems Iliad and Odyssey by Homer.",Anatolia
The Trojan Horse,1961,1200-1150 BC,-1200,-1150,50,Set in western Anatolia in the 10th and final year of the Trojan War.,Anatolia
How the West Was Won,1962,1839-1889,1839,1889,50,United States expansion into and settlement of the West.,Illinois
The Fury of Achilles,1962,1200-1150 BC,-1200,-1150,50,"Set in western Anatolia in the 9th year of the Trojan War, based on the epic poem Iliad by Homer. King Agamemnon of Mycenae has lost his slave concubine Chryseis, and demands Briseis as a replacement concubine. Briseis is the slave concubine of Achilles, the leader of the Myrmidons, and Achilles feels insulted due to having to give her up to his superior. In retaliation, Achilles refuses to fight or lead his troops alongside the other Greek forces. The Trojans temporarily start gaining an advantage in the ongoing war.",Anatolia
The Avenger,1962,1200-1150 BC,-1200,-1150,50,"Aeneas struggles to establish a new home-land in the Italian Peninsula for his fellow survivors of the Trojan War. The film is based on the epic poem Aeneid by Virgil, which depicts Aeneas and his Trojan colonists as ancestor of the Romans.",Anatolia
Electra,1962,1200-1150 BC,-1200,-1150,50,"Set in the aftermath of the Trojan War in Mycenae, based on the theatrical play Electra by Euripides and the traditional accounts of conflicts within the family of the Atreidai. Agamemnon, King of Mycenae returned victorious from the Trojan War, but was assassinated by his own wife Clytemnestra and by his first cousin Aegisthus (who served as Clytemnestra's lover and a rival claimant to the throne). Years, later Electra (the daughter of Agamemnon and Clytemnestra) seeks revenge for her father's murder, by plotting the assassinations of both her mother and her stepfather.",Mycenae
The Odyssey,1968,1200-1150 BC,-1200,-1150,50,Based on the epic poem Odyssey by Homer.,Anatolia
The Trojan Women,1971,1200-1150 BC,-1200,-1150,50,"Set in the immediate aftermath of the Trojan War, based on the theatrical play The Trojan Women by Euripides. The city of Troy has been sacked and the victors of the war are taking decisions on the fates of surviving captives. The film focuses on the fates of female captives Hecuba, Andromache, Cassandra, and Helen of Sparta. Meanwhile, Astyanax, the underage heir to the Trojan throne and relative of all four women, is scheduled for execution.",Anatolia
Iphigenia,1977,1200-1150 BC,-1200,-1150,50,"Set in the port town of Aulis, Greece immediately before the Greek expeditionary force set sails to attack Troy. Due to unfavorable weather conditions, king Agamemnon of Mycenae offers his daughter Iphigenia as a human sacrifice to the goddess Artemis. The film is based on the theatrical play Iphigenia in Aulis by Euripides.",Aulis
Kristin Lavransdatter,1995,early-to-mid-1400 ,1400,1450,50,About a noblewoman with an arranged marriage who falls in love with someone else.,Norway
The Odyssey,1997,1200-1150 BC,-1200,-1150,50,"Set in the aftermath of the Trojan War, based on the epic poem Odyssey by Homer. It depicts the ten-year struggle of war veteran Odysseus to return home to the island of Ithaca following the war.",Anatolia
Helen of Troy,2003,1200-1150 BC,-1200,-1150,50,"TV miniseries set in western Anatolia during the Trojan War, loosely based on the epic poem Iliad by Homer.",Anatolia
Troy,2004,1200-1150 BC,-1200,-1150,50,"Set in western Anatolia during the Trojan War, loosely based on the epic poem Iliad by Homer.",Anatolia
The Scorpion King 2: Rise of a Warrior,2008,2334-2284 BC/ 1792 - c. 1750 BC,-2334,-2284,50,"A fictional story about Mathayus who aims to avenge the death of his father at the hand of Sargon, now king of Akkad. In this movie appear a fictional version of king Hammurabi of Babylon.",Egypt
The Pillars of the Earth,2010,1120-1170,1120,1170,50,during the civil wars between King Stephen and his cousin Maud,England
The Red Tent,2014,1700-1750 BC,-1700,-1750,50,"Miniseries set in The Holy Land during the time of the Old Testament patriarchs of the Book of Genesis. Dinah, the only daughter of Leah and Jacob, chronicles her story from youth through adulthood.",
Cathedral of the Sea,2018,1320-1370,1320,1370,50,"The action takes place in 14th century Barcelona at the height of the city's trade and military power in the Mediterranean, during the construction of Santa Maria del Mar serving as background to the story.",Barcelona
Troy: Fall of a City,2018,1200-1150 BC,-1200,-1150,50,Miniseries that tells the story of the 10-year siege of Troy.,Anatolia
Mughal-e-Azam,1960,1556-1605,1556,1605,49,"The Story of Akbar the Great, Mughal emperor and his son Jahangir. Jahangir's relationship with slave girl Anarkali is featured.",Agra
681 AD: The Glory of Khan,1981,632-681,632,681,49,epic about the fall of Old Great Bulgaria and the creation of modern-day Bulgaria; focuses on Kanasubigi Asparuh's life,Bulgaria
The Emperor's Shadow,1996,259-210 BC,-259,-210,49,about a troubled friendship between Qin Shi Huang and the musician Gao Jianli,China
Omar,2012,595-644,595,644,49,"the life of Omar ibn Al-Khattab, one of the companions of Muhammad",Mecca
Teodora,1921,500-548,500,548,48,Byzantine empress Theodora,Istanbul
"Theodora, Slave Empress",1954,500-548,500,548,48,Byzantine empress Theodora,Istanbul
The Three Musketeers,1973,1625-1673,1625,1673,48,"Based on the novels (The Three Musketeers and its sequels) by Alexandre Dumas. The protagonists are loosely based on historical figures Charles de Batz-Castelmore d'Artagnan, Armand d'Athos, Isaac de Porthau, and Henri d'Aramitz.",France
Sign of the Pagan,1954,406-453,406,453,47,Rome – the Huns conquests and the downfall of the Roman Empire,Rome
Attila,1954,406-453,406,453,47,Rome – the Hunnic leader up to his retreat from the Po river,Rome
Attila,2001,406-453,406,453,47,Rome – the life and death of the famous Hunnic leader,Rome
The Liberator (film),2013,1783-1830,1783,1830,47,Life of Simon Bolivar,
The Great King,1942,1740-1786,1740,1786,46,It depicts the life of Frederick the Great,Germany
Aguila,1980,1899-1945,1899,1945,46,Philippine history,Philippines
Viking,2016,970-1016,970,1016,46,Vladimir I of Kiev,Kiev
Francis of Assisi,1961,1181-1226,1181,1226,45,Francis of Assisi,Italy
Elizabeth R,1971,1558-1603,1558,1603,45,The reign of Elizabeth I of England.,England
"Brother Sun, Sister Moon",1972,1181-1226,1181,1226,45,Francis of Assisi,Italy
Francesco,1989,1181-1226,1181,1226,45,Francis of Assisi,Italy
The Virgin Queen,2005,1558-1603,1558,1603,45,The reign of Elizabeth I of England.,England
A Frozen Flower,2008,1330-1374,1330,1374,44,Set during the late Goryeo Dynasty.,Korea
Les Rois maudits,1972,1285-1328,1285,1328,43,the later Capetian dynasty and the arrest of the order of the Knights Templar and the seizure of their wealth by the French crown in 1307,France
Peter the Great,1984,1682-1725,1682,1725,43,The reign of Peter I of Russia,Russia
Les Rois maudits,2005,1285-1328,1285,1328,43,the later Capetian dynasty and the arrest of the order of the Knights Templar and the seizure of their wealth by the French crown in 1307,France
Belle,2013,1761-1804,1761,1804,43,"The true history of Dido Elizabeth Belle, a mixed–race daughter of British Naval officer John Lindsay and an African woman. She was taken to England by her father to be raised by his uncle, William Murray, 1st Earl of Mansfield, as an aristocratic Lady, as befits her blood line. This forces Lord Mansfield, the Lord Chief Justice, to confront his own views on race, society and the antiquated laws of the time.",England
"I, Claudius",1976,12 BC-54 AD,-12,-54,42,Rome – the reigns and family life of the Julio-Claudians,Rome
Fearless,2006,1868-1910,1868,1910,42,a biographical film about late Qing Dynasty martial artist Huo Yuanjia,China
"Carlos, rey emperador",2015,1516-1558,1516,1558,42,"The series tells the story of Charles I or Charles V, Holy Roman Emperor, one of the most powerful men Europe has met.",Roman
The Caesars,1967,27 BC-68 AD,-27,-68,41,Rome – the Julio-Claudian dynasty,Rome
Pope Joan,2009,814-855,814,855,41,Fictitious medieval legend of a woman who disguised herself as a man and rose to the status of Pope in the Middle Ages.,France
Sye Raa Narasimha Reddy,2019,1806-1847,1806,1847,41,Based on the life of Uyyalawada Narasimha Reddy,India
Samson and Delilah,1949,1118-1078 BC,-1118,-1078,40,"A romantic biblical drama film which depicts the story of Samson, a strongman whose secret lies in his uncut hair, and his love for Delilah, the woman who seduces him. Samson and Delilah are characters in the Book of Judges, where Samson is depicted as the last of the Biblical judges in its narrative, and Delilah as a woman of Nahal Sorek who was bribed by the lords of the Philistines to learn his secrets.",Gaza
Maria Theresa,1951,1740-1780,1740,1780,40,Depicts the life of Maria Theresa,Austria
"Nefertiti, Queen of the Nile",1961,1370-1330 BC,-1370,-1330,40,"Set in Ancient Egypt; loosely based on the life of Nefertiti, Great Royal Wife of the Pharaoh Akhenaten. Nefertiti and her husband were members of the Eighteenth Dynasty of Egypt, and were ruling figures of the Amarna Period.",Egypt
The Castilian,1963,930-970,930,970,40,Ferdinand Gonzalez: an early hero of the Spanish Reconquista,Spain
The Return of Martin Guerre,1982,1548-1588,1548,1588,40,The case of Martin Guerre in France – a true case of identity theft.,France
George Washington,1984,1743-1783,1743,1783,40,George Washington's life up to the American Revolutionary War,"Westmoreland County, VA"
Samson,2018,1118-1078 BC,-1118,-1078,40,Samson is a 2018 Biblical drama film directed by Bruce Macdonald and inspired by the story of Samson in the Book of Judges.,Gaza
Veerapandiya Kattabomman,1959,1760-1799,1760,1799,39,"About the resistance of Veerapandiya Kattabomman to the Company rule in India, rule of the East India Company",India
Redbad,2018,c.680-719,680,719,39,"a Dutch drama film based on the life of Redbad, King of the Frisians, who is often considered the last independent ruler of Frisia before Frankish domination",Frisia
The Private Life of Henry VIII,1933,1509-1547,1509,1547,38,Henry VIII of England,England
The Six Wives of Henry VIII,1970,1509-1547,1509,1547,38,Henry VIII of England,England
The Ceremony of Innocence,1970,978-1016,978,1016,38,a fictionalized version of the reign of Æthelred the Unready,England
Henry VIII and His Six Wives,1972,1509-1547,1509,1547,38,Henry VIII of England,England
Burebista,1980,82-44 BC,-82,-44,38,The reign of King Burebista of Dacia(modern day Romania),Romania
Monarch,2000,1509-1547,1509,1547,38,Henry VIII of England,England
Henry VIII,2003,1509-1547,1509,1547,38,Henry VIII of England,England
Vijaya Kuweni,2012,543-505 BC,-543,-505,38,based on the historical tale of Wijaya-Kuveni,India
Turn: Washington's Spies,2014,1776-1814,1776,1814,38,American Revolutionary War,northeastern united states
Ekaterina,2014,1744-1782,1744,1782,38,Catherine II of Russia,Russia
A Tale of Two Cities,1911,1755-1792,1755,1792,37,England and France prior and during the French Revolution.,France
A Tale of Two Cities,1935,1755-1792,1755,1792,37,England and France prior and during the French Revolution.,France
A Tale of Two Cities,1958,1755-1792,1755,1792,37,England and France prior and during the French Revolution.,France
King of Kings,1961,4 BC to 30-33 AD,-4,33,37,Judea – Dramatization of the story of Jesus of Nazareth from his birth and ministry to his crucifixion and resurrection.,bethlehem
Kazimierz Wielki,1976,1333-1370,1333,1370,37,Casimir III the Great of Poland,Poland
Jesus of Nazareth,1977,4 BC to 30-33 AD,-4,33,37,Judea – the life of Jesus Christ,bethlehem
A Tale of Two Cities,1980,1755-1792,1755,1792,37,England and France prior and during the French Revolution.,France
King Naresuan,2007,1555-1592,1555,1592,37,"The film is set after event in The Legend of Suriyothai about Naresuan, the King of Siam who executes the plotters and ceremoniously declares Ayutthaya free and sovereign from Hanthawadi",Thailand
Mongol,2007,1192-1229,1192,1229,37,based on the early life of Genghis Khan,Mongolia
Diane,1956,1523-1559,1523,1559,36,Based on the relationship between Diane de Poitiers and Henry II of France.,France
Vera Puran Appu,1979,1812-1848,1812,1848,36,based on freedom fighter Puran Appu,Sri Lanka
Asoka,2001,268 - 232 BC,-268,-232,36,"fictionalized account of the reign of Ashoka (r. ), of the Mauryan Empire in India",India
Charles II: The Power and The Passion,2003,1649-1685,1649,1685,36,The reign of Charles II of England,England
Genghis Khan: To the Ends of the Earth and Sea,2007,1192-1228,1192,1228,36,Japanese-Mongolian film about the life of Genghis Khan,Mongolia
Genghis Khan,1950,1192-1227,1192,1227,35,Life of the Mongol Emperor and the Succession of his throne.,Mongolia
The Flame and the Arrow,1950,1155-1190,1155,1190,35,"Dardo, a Robin Hood-like figure, and his loyal followers use a Roman ruin in Medieval Lombardy as their headquarters as they conduct an insurgency against their Hessian conquerors.",Northern Italy
The Conqueror,1956,1192-1227,1192,1227,35,"A film about the life of Temüjin, who later came to be known as Genghis Khan",Mongolia
The Conqueror,1956,1192-1227,1192,1227,35,"universally panned as a terrible film, this English-language film starred John Wayne as Genghis Khan",Mongolia
Genghis Khan,1965,1192-1227,1192,1227,35,the life and conquests of the Mongol emperor,Mongolia
Amadeus,1984,1756-1791,1756,1791,35,Austria composer Wolfgang Amadeus Mozart,Austria
Jose Rizal,1998,1861-1896,1861,1896,35,"The life of the Philippine National Hero, José Rizal.",Philippines
Imperium: Augustus,2003,49 BC-14 AD,-49,-14,35,"Rome – the life of Augustus, the first emperor",Rome
Prince Vladimir,2006,980-1015,980,1015,35,Vladimir I of Kiev,Kiev
Mongol,2007,1192-1227,1192,1227,35,"A film about the early life of Temüjin, who later came to be known as Genghis Khan",Mongolia
The Black Rose,1950,1260 - 1294,1260,1294,34,English-language film about an English Saxon who travels China and meet a Mongol warlord,China
The War Lord,1965,1066-1100,1066,1100,34,A knight in the service of a duke goes to a coastal village where an earlier attempt to build a defensive castle has failed.,France
Lady Oscar,1979,1755-1789,1755,1789,34,"The woman Oscar François de Jarjayes is raised as a man by her father, later gaining a career as a guard for Marie Antoinette.",France
Bayani,1992,1863-1897,1863,1897,34,The life of Andres Bonifacio.,Philippines
Imperium: Saint Peter,2005,33-67,33,67,34,Saint Peter,Jerusalem
Anonymous,2011,1570-1604,1570,1604,34,"Life of Edward de Vere, 17th Earl of Oxford, an Elizabethan courtier, playwright, poet and patron of the arts, suggested as the actual author of William Shakespeare's plays.",England
World Without End,2012,1327-1361,1327,1361,34,"A sequel to the 2010 miniseries The Pillars of the Earth, set in England during the 1300s",England
The Last Kingdom,2015,866-late 900 ,866,900,34,Viking Age,England
Alexander the Great,1956,356-323 BC,-356,-323,33,Ancient kingdom of Macedonia and Persia,Skopje
Barry Lyndon,1975,1756-1789,1756,1789,33,"The Seven Years' War, etc.",North America
The Libertine,2004,1647-1680,1647,1680,33,"Life of the poet John Wilmot, 2nd Earl of Rochester",France
Alexander,2004,356-323 BC,-356,-323,33,Ancient kingdom of Macedonia and Persia,Skopje
El Greco,2007,1567-1600,1567,1600,33,"Greek biographical film about the life of the Greek painter of the Spanish Renaissance, Doménikos Theotokópoulos, known as El Greco.",Spain
Sangolli Rayanna,2012,1798-1831,1798,1831,33,"Film is about Sangolli Rayanna, a prominent general from Karnataka, who fought against the East India Company until he was captured and executed in 1831.",Karnataka
Siri Parakum,2013,1153-1186,1153,1186,33,based on the historical legend of King Parakramabahu I the Great,Sri Lanka
The Tudors,2007,1514-1547,1514,1547,33,Henry VIII of England,England
Mircea,1989,1386-1418,1386,1418,32,"Mircea the Elder, who repelled the Ottoman Empire during his reign",Wallachia
"Charlemagne, le prince à cheval",1993,768-800,768,800,32,Charlemagne's reign up to his coronation as emperor in 800,France
The Duchess,2008,1774-1806,1774,1806,32,"The life of Georgiana Cavendish, Duchess of Devonshire",Devonshire
The Divine Weapon,2008,1418-1450,1418,1450,32,Set during the reign of Sejong the Great.,Korea
Catherine the Great,2019,1764-1796,1764,1796,32,Catherine II of Russia,Russia
Barrabas,1961,33-64,33,64,31,"Rome – ending reign of Tiberius, the reign of Nero",Rome
Taj Mahal: An Eternal Love Story,2005,1627-1658,1627,1658,31,Story of Shah Jahan and his Queen Mumtaz Mahal and history of the monument Taj Mahal built to honour Mumtaz Mahal after her death.,Taj Mahal
The Last Valley,1970,1618-1648,1618,1648,30,"Set in the Kingdom of Germany, Holy Roman Empire during the Thirty Years' War.",Germany
Ilustrado,2014,1860-1890,1860,1890,30,The film tells the story about José Rizal's early life as a teenager and his tragic first love.,Philippines
In the Heart of the Sea,2015,1820-1850,1820,1850,30,the story of the whaleship Essex which inspired the writing of Moby-Dick,Essex
Reign (TV series),2013,1557-1587,1557,1587,30,"78-episode TV series about Mary, Queen of Scots and Elizabeth I of England.",England
The Last Woman of Shang,1964,1075-1046 BC,-1075,-1046,29,"a Hong Kong film about Daji, a concubine of King Zhou of Shang",China
Alfred the Great,1969,870-899,870,899,29,"Alfred the Great, king of Wessex repels the army of Guthrum and begins the unification of England",England
Young Winston,1972,1874-1902,1874,1902,28,The biography Winston Churchill before he became Prime Minister of the United Kingdom during World War II.,UK
"Mary, Queen of Scots",1971,1560-1587,1560,1587,27,"Mary, Queen of Scots",England
Nero,2004,41-68,41,68,27,Rome – spanning the reigns of Claudius and Nero,Rome
Rudhramadevi,2015,1262-1289,1262,1289,27,Based on the life of Rudrama Devi and her achievements during her ruling period,India
The Last Roman,1968,526-553,526,553,27,the Ostrogoths' struggle against the Byzantine emperor Justinian I and his generals Belisarius and Narses – adaption of a novel by Felix Dahn,Istanbul
Mary of Scotland,1936,1561-1587,1561,1587,26,"Mary, Queen of Scots",England
Sudan,1945,2558-2532 BC,-2558,-2532,26,"Set during the reign of the pharaoh Khafre (Chephren), a member of the Fourth Dynasty of Egypt.",Egypt
Du Guesclin,1948,1354-1380,1354,1380,26,"Bertrand du Guesclin, a Constable of France in the Hundred Years' War",France
Napoleon (miniseries),2002,1795-1821,1795,1821,26,Historical miniseries which explored the life of Napoleon Bonaparte,France
Confucius,2010,505-479 BC,-505,-479,26,starring Chow Yun-fat as Confucius,China
Sacrifice,2010,607-581 BC,-607,-581,26,"based on the play The Orphan of Zhao, set in the Jin state during the Spring and Autumn period",China
"Mary, Queen of Scots",2018,1561-1587,1561,1587,26,"Mary, Queen of Scots",England
"Ganito Kami Noon, Paano Kayo Ngayon?",1970,1870-1895,1870,1895,25,The film depicts the Hispinized Society of the Philippines during the Spanish Period.,Philippines
Luther,2003,1505-1530,1505,1530,25,Martin Luther,Germany
Elizabeth I,2005,1578-1603,1578,1603,25,The last 25 years of the reign of Elizabeth I of England.,England
Bonifacio: Ang Unang Pangulo,2014,1872-1897,1872,1897,25,"The life of Philippine Revolutionary Andres Bonifacio from his founding of the Katipunan to his eventual execution. The film focused on the hypothesis that he, not Emilio Aguinaldo, was the first President of the Philippines.",Philippines
Laal Kaptaan,2019,1764-1789,1764,1789,25,A revenge drama set after the events of the Battle of Buxar,India
Maharaja Gemunu,2015,161-137 BC,-161,-137,24,based on the odyssey of King Dutugamunu,Sri Lanka
The Count of Monte Cristo,1934,1815-1838,1815,1838,23,France after Napoleon I (Bourbon Restoration and July Monarchy),France
Land of the Pharaohs,1956,2589-2566 BC,-2589,-2566,23,"Based on the reign of Pharaoh Khufu (Cheops), a member of the Fourth Dynasty of Egypt.",Egypt
Cleopatra's Daughter,1960,2589-2566 BC,-2589,-2566,23,"Based on the reign of Pharaoh Khufu (Cheops), a member of the Fourth Dynasty of Egypt.",Egypt
The Count of Monte Cristo,1975,1815-1838,1815,1838,23,France after Napoleon I (Bourbon Restoration and July Monarchy),France
Beatrice Cenci,1909,1577-1599,1577,1599,22,About the life events of Beatrice Cenci.,Rome
Beatrice Cenci,1926,1577-1599,1577,1599,22,About the life events of Beatrice Cenci.,Rome
Queen Christina,1933,1632-1654,1632,1654,22,"Christina, Queen of Sweden",Sweden
Beatrice Cenci,1941,1577-1599,1577,1599,22,About the life events of Beatrice Cenci.,Rome
Young Bess,1953,1536-1558,1536,1558,22,From the death of Anne Boleyn to the coronation of Elizabeth I of England.,England
Beatrice Cenci,1956,1577-1599,1577,1599,22,About the life events of Beatrice Cenci.,Rome
Beatrice Cenci,1969,1577-1599,1577,1599,22,It depicts real life events of Francesco and Beatrice Cenci.,Rome
Ludwig,1973,1864-1886,1864,1886,22,Life and death of King Ludwig II of Bavaria.,Bavaria
Mrs Brown,1997,1861-1883,1861,1883,22,The relationship between Queen Victoria of the United Kingdom of Great Britain and Ireland and her personal servant John Brown.,UK
The Devil's Whore,2008,1638-1660,1638,1660,22,The English Civil War and the reign of Oliver Cromwell,England
Rome,2005,52-30 BC,-52,-30,22,from the end of the Gallic Wars to the death of Mark Antony and the beginning of the Principate,Italy
Sins of Jezebel,1953,874-853 BC,-874,-853,21,"Set in the Southern Beirut, Lebanon, during the reign of Ahab, Kings of Israel. The film depicts the reign of the Omrides, based on Books of Kings and the Books of Chronicles. Jezebel, Ahab's queen comsort, is depicted as having an extramarital affair with the military commander Jehu. This contradicts the traditional narrative, where Jezebel never has extramarital affairs and where she is assassinated by Jehu during the coup d'état which elevated him to the throne.",Israel
Wyatt Earp,1994,1863-1884,1863,1884,21,Events leading up to and following the Gunfight at the O.K. Corral,Tombstone
Dangerous Beauty,1998,1562-1583,1562,1583,21,"The film is about Veronica Franco, a courtesan in 16th-century Venice who becomes a hero to her city, but later becomes the target of an inquisition by the Church for witchcraft.[3]",Venice
Domina,2021,43-22 BC,-43,-22,21,"The life and rise of Livia Drusilla, the powerful wife of the Roman emperor Augustus Caesar.",Rome
Tenali Ramakrishna,1956,1509-1529,1509,1529,20,Based on the life of Telugu poet Tenali Ramakrishna,India
Erik the Conqueror,1961,786-806,786,806,20,Two estranged brothers confront each other as rivals when war breaks out between Anglo-Saxon kingdoms and the Vikings.,England
Mayura,1975,345 - 365,345,365,20,Based on the Kadamba Dynasty's King Mayurasharma set in India,India
St. Thomas,1975,52-72,52,72,20,Rome – low budget Indian film on the missionary work of Thomas the Apostle in India.,India
Bajirao Mastani,2015,1720-1740,1720,1740,20,Based loosely on the life of Bajirao I and his controversial marriage to his Muslim wife Mastani albeit with lot of inaccuracies.,India
Poldark,2015,1781-1801,1781,1801,20,Adaptation of Winston Graham's novels set in Cornwall in the late 18th century,Cornwall
Madame Sans-Gêne,1961,1792-1811,1792,1811,19,Historical comedy-drama during the reign of Napoleon,France
Cleopatra,1917,48-30 BC,-48,-30,18,Egypt and Rome – follows her relationships first with Julius Caesar and then with Mark Antony,Egypt
The Scarlet Empress,1934,1744-1762,1744,1762,18,Catherine II of Russia,Russia
The Rise of Catherine the Great,1934,1744-1762,1744,1762,18,Catherine II of Russia,Russia
Cleopatra,1934,48-30 BC,-48,-30,18,Egypt and Rome – follows her relationships first with Julius Caesar and then with Mark Antony,Egypt
Marie Antoinette,1938,1774-1792,1774,1792,18,"Marie Antoinette, Queen consort of France",France
Marie Antoinette Queen of France,1956,1774-1792,1774,1792,18,"Marie Antoinette, Queen consort of France",France
Cleopatra,1963,48-30 BC,-48,-30,18,Egypt and Rome – follows her relationships first with Julius Caesar and then with Mark Antony,Egypt
Butch Cassidy and the Sundance Kid,1969,1890-1908,1890,1908,18,"Covers the activities of Butch Cassidy and Harry Longabaugh, prominent members of Butch Cassidy's Wild Bunch. The Wild Bunch was a loosely organized outlaw gang from Wyoming.",Wyoming
Witchhammer,1970,1678-1696,1678,1696,18,Northern Moravia witch trials,czech republic
Lady Caroline Lamb,1972,1810-1828,1810,1828,18,"Lady Caroline Lamb, the British aristocrat, novelist and Lord Byron's lover",UK
Catherine the Great,1995,1744-1762,1744,1762,18,Catherine II of Russia,Russia
Cleopatra,1999,48-30 BC,-48,-30,18,Egypt and Rome – follows her relationships first with Julius Caesar and then with Mark Antony,Egypt
Marie Antoinette,2006,1774-1792,1774,1792,18,"Marie Antoinette, Queen consort of France",France
Arn – The Kingdom at Road's End,2008,1187-1205,1187,1205,18,"following the Battle of Hattin, the knight returns home to Sweden and participates in the civil wars","Beirut, Lebanon"
Maria Theresia,2017,1723-1741,1723,1741,18,Depicts the life of the young Maria Theresa,Austria
Poldark,1975,1781-1799,1781,1799,18,Adaptation of Winston Graham's novels set in Cornwall in the late 18th century,Cornwall
Les Miserables,1934,1815-1832,1815,1832,17,France after Napoleon I (Bourbon Restoration and July Monarchy),France
Les Miserables,1935,1815-1832,1815,1832,17,France after Napoleon I (Bourbon Restoration and July Monarchy),France
Les Miserables,1995,1815-1832,1815,1832,17,France after Napoleon I (Bourbon Restoration and July Monarchy),France
Les Miserables,1998,1815-1832,1815,1832,17,France after Napoleon I (Bourbon Restoration and July Monarchy),France
The Sino-Dutch War 1661,2000,1645-1662,1645,1662,17,"based on the story of Koxinga (1624–1662), with the focus on the Siege of Fort Zeelandia",China
Gangs of New York,2002,1846-1863,1846,1863,17,"New York City prior and during the American Civil War. The events occur in the crime- infested neighborhood of Five Points, Manhattan. The film opens in 1846 with a conflict between a Nativist gang and the Dead Rabbits. The action then moves forward to the 1860s with the Nativists still active and involved with William M. Tweed, ""boss"" of Tammany Hall. The action culminates in the New York City draft riots of 1863.",New York City
Les Miserables,2012,1815-1832,1815,1832,17,France after Napoleon I (Bourbon Restoration and July Monarchy),France
A Royal Affair,2012,1766-1783,1766,1783,17,"Set at the court of the mentally ill King Christian VII of Denmark, and focuses on the romance between his wife, Caroline Matilda of Great Britain, and the royal physician Johann Friedrich Struensee.",Denmark
Pompeii,2014,62-79,62,79,17,Pompeii in the days leading up to the eruption of Mount Vesuvius,Pompeii
Les Miserables,2018,1815-1832,1815,1832,17,France after Napoleon I (Bourbon Restoration and July Monarchy),France
Napoleon,1927,1799-1815,1799,1815,16,Napoléon I of France,France
Cardinal Richelieu,1935,1626-1642,1626,1642,16,The life of the great 17th-century French statesman Cardinal Richelieu and his dealings with Louis XIII of France,France
Gone with the Wind,1939,1861-1877,1861,1877,16,Georgia during the American Civil War and the Reconstruction Era.,"Georgia, US"
Song of Love,1947,1840-1856,1840,1856,16,The marriage of Robert and Clara Schumann and their close friendship with Johannes Brahms. All three were notable composers.,Germany
Desiree,1954,1799-1815,1799,1815,16,The love story between Désirée Clary and Napoleon I,France
Jupiter's Darling,1955,218-202 BC,-218,-202,16,during the Second Punic War,Sicily
Hannibal,1959,218-202 BC,-218,-202,16,during the Second Punic War,Sicily
Riel,1979,1869-1885,1869,1885,16,"The activities of Louis Riel, a Métis in both the Red River Rebellion of Manitoba and the North-West Rebellion in the District of Saskatchewan.",Saskatchewan
The Count of Monte Cristo,2002,1815-1831,1815,1831,16,"France after Napoleon I (Bourbon Restoration and July Monarchy); Unlike the first two films, this version states 1814 at the start. Dantes' plan happens over a three-year period, having been imprisoned for thirteen years, as is stated during the film. The ending is set shortly after Albert's sixteenth birthday, having been born in 1815.",France
Hannibal – Rome's Worst Nightmare,2006,218-202 BC,-218,-202,16,during the Second Punic War,Sicily
Cabiria,1914,218-202 BC,-218,-202,16,during the Second Punic War,Sicily
Knightfall,2017,1291-1307,1291,1307,16,"recounts the success, fall, persecution, and suppression of the Knights Templar",France
Becket,1964,1155-1170,1155,1170,15,"archbishop Thomas Becket, once a close personal friend of Henry II",England
King Arthur,2004,452-467,452,467,15,the Roman withdrawal from Britain and the Battle of Mount Badon,UK
King Danylo – Kingdom Of Swords,2018,1238-1253,1238,1253,15,"King Daniel of Galicia, the first King of Rus'.",Portugal
Quo Vadis,1951,54-68,54,68,14,Rome during the reign of Nero,Rome
Serpent of the Nile,1953,44-30 BC,-44,-30,14,Tells the story of the Egyptian Queen Cleopatra and her relationship with the Roman general Mark Anthony from just after the assassination of Julius Caesar.,Egypt
Sun in the Last Days of the Shogunate,1957,1853-1867,1853,1867,14,"Awards: 1 Blue Ribbon Award, 1 Kinema Junpo Award, 1 Mainichi Film Concours",Japan
Shinobi no Mono 6: Iga Mansion,1965,1637-1651,1637,1651,14,,Japan
Quo Vadis,1985,54-68,54,68,14,Rome during the reign of Nero,Rome
Quo Vadis,2001,54-68,54,68,14,Rome during the reign of Nero,Rome
The Promise,2005,766-780,766,780,14,Set during the end of the Tang dynasty,China
The Warlords,2007,1850-1864,1850,1864,14,set in the Qing Dynasty during the Taiping Rebellion,China
The Last Legion,2007,476-490,476,490,14,connecting (in heavily fictionalized fashion) the deposition of the last Roman emperor Romulus Augustus by Odoacer with the Battle of Mount Badon,UK
Prithviraj,2021,1178-1192 CE,1178,1192,14,The film is based on life of Prithviraj Chauhan[2],India
Antony and Cleopatra (many adaptations),1908,44-30 BC,-44,-30,14,Shakespeare's play about the relationship between Cleopatra and Mark Antony,Egypt
Sheba and the Gladiator,1959,260-273,260,273,13,Rome and the Palmyrene Empire during the reigns of Aurelian and Zenobia,Rome
Cromwell,1970,1640-1653,1640,1653,13,The English Civil War and the dissolution of the Rump Parliament,England
Northern Crusades,1972,1260-1273,1260,1273,13,the Great Prussian Uprising against the Teutonic Knights during the Northern Crusades,Germany
Great Liao's Empress Dowager,1995,969-982,969,982,13,a Chinese film about Empress Xiao Yanyan,China
The Current War,2017,1880-1893,1880,1893,13,"the 19th-century competition between Thomas Edison and George Westinghouse over which electric power delivery system would be used in the United States (often referred to as the ""war of the currents"").",Northeastern US
Victoria,2016,1837-1850,1837,1850,13,Life of Queen Victoria,UK
War and Peace,1956,1803-1815,1803,1815,12,The Russian Empire during the Napoleonic era,Russia
Shinobi no Mono 2: Vengeance,1963,1582-1594,1582,1594,12,Based on the novel of the same name.,Japan
The Two Gladiators,1964,180-192,180,192,12,Rome during the reign of Commodus,Rome
The Fall of the Roman Empire,1964,180-192,180,192,12,Rome during the reign of Commodus,Rome
Anne of the Thousand Days,1969,1524-1536,1524,1536,12,"Anne Boleyn, Queen Consort of King Henry VIII and the mother of Queen Elizabeth I.",London
Gladiator,2000,180-192,180,192,12,Rome - spanning the reigns of Marcus Aurelius and Commodus,Rome
The King and the Clown,2005,1494-1506,1494,1506,12,Set during the reign of Yeonsangun of Joseon.,Korea
12 Years a Slave,2013,1841-1853,1841,1853,12,The story of free African American Solomon Northup after he was abducted and sold into slavery. Based on the autobiography of the same name,New York
La corona partida,2016,1504-1516,1504,1516,12,"After the death of Queen Isabella I of Castile, both Ferdinand II of Aragon and Felipe el Hermoso fight to succeed her.",Castile
Harakiri,1962,1619-1630,1619,1630,11,Set in Japan during the Edo period,Japan
Harakiri,1962,1619-1630,1619,1630,11,,Japan
Ridicule,1996,1783-1794,1783,1794,11,On the brink of the French Revolution. A minor baron and engineer from Lyon tries to gain audience with King Louis XVI of France to fund drainage of the mosquito-infested swamps bringing sickness and death to his region.,France
Vanity Fair,2004,1803-1814,1803,1814,11,The Napoleonic era,Russia
The Assassination of Jesse James by the Coward Robert Ford,2007,1881-1892,1881,1892,11,"The end of Jesse James' career as a criminal and the man who eventually kills him, Robert Ford in 1882","Saint Joseph, MO"
Princess Kaiulani,2009,1887-1898,1887,1898,11,based on the life of Princess Ka?iulani of the Kingdom of Hawai?i,Hawaii
Sons of Liberty,2015,1765-1776,1765,1776,11,A story about the Founding Fathers of the United States and the American Revolution.,northeastern united states
Black Sails,2014,1715-1726,1715,1726,11,Set roughly two decades before the events of Treasure Island and during the Golden Age of Piracy,Nassau
Conquest,1937,1806-1816,1806,1816,10,The love story between Marie Walewska and Napoleon I,France
A Man for All Seasons,1966,1525-1535,1525,1535,10,Thomas More,London
The Duellists,1977,1804-1814,1804,1814,10,The Napoleonic Wars,France
Mountains of the Moon,1990,1854-1864,1854,1864,10,Journey of Richard Francis Burton and John Hanning Speke in their expedition to Central Africa and the rivalry that followed,Africa
To Kill a King,2003,1648-1658,1648,1658,10,"The reign of Oliver Cromwell, Lord Protector.",England
Admiral,2015,1640-1650,1640,1650,10,The life of Michiel de Ruyter and the Dutch civil war,Netherlands
Tommy's Honour,2016,1866-1876,1866,1876,10,The complex and bittersweet relationship between the pioneering and legendary Scottish golfing champions Old Tom Morris and Young Tom Morris.,Scotland
George Washington II: The Forging of a Nation,1986,1788-1797,1788,1797,9,George Washington's life during his time as President of the United States.,"Washington, DC"
Braveheart,1995,1296-1305,1296,1305,9,"William Wallace, a Scotsman who fought for Scotland's independence in the 1290s",Great Britain
The Bruce,1996,1305-1314,1305,1314,9,"Robert the Bruce, who took over the rebellion against Edward ""Longshanks"" following the death of William Wallace in 1305",Scotland
Elizabeth,1998,1554-1563,1554,1563,9,The early reign of Elizabeth I of England.,England
Tut,2015,1332-1323 BC,-1332,-1323,9,"The three-part miniseries is based on the life of Egyptian pharaoh Tutankhamun, a member of the Eighteenth Dynasty of Egypt.",Egypt
Bouboulina,1959,1821-1829,1821,1829,8,"Laskarina Bouboulina, heroine of the Greek War of Independence",Greece
Caesar the Conqueror,1962,58-50 BC,-58,-50,8,Julius Caesar leads the Roman army to battle against rebels in Gaul.,Rome
The Long Ships,1964,982-990,982,990,8,"A vagabond Viking adventurer and a Moor both compete to find ""The Mother of All Voices"", a legendary golden bell near the Pillars of Hercules.",Denmark
The Magnificent Gladiator,1964,260-268,260,268,8,Rome during the reign of Gallienus,Rome
Mihai Viteazul,1970,1593-1601,1593,1601,8,"Michael the Brave, prince of Wallachia, Moldavia and Transylvania.",Transylvania
Arn – The Knight Templar,2007,1179-1187,1179,1187,8,a Swedish knight is sent to Jerusalem as penance while his lover languishes in a convent,Jurusalem
A.D. The Bible Continues,2015,33-41,33,41,8,"Beginning with the crucifixion and resurrection of Jesus, and continues with the first ten chapters of the Book of Acts.",Jerusalem
Silence,2016,1630-1638,1630,1638,8,Jesuit priests from Portugal attempt to spread Catholic Christianity in Edo-era Japan,Japan
Silence,2016,1630-1638,1630,1638,8,Based on the novel of the same name.,Korea
The Spanish Princess (TV series),2019,1501-1509,1501,1509,8,Catherine of Aragon,Aragon
Robert the Bruce,2019,1306-1314,1306,1314,8,The story follows Robert the Bruce during the First War of Scottish Independence,Scotland
Messalina,1951,41-48,41,48,7,Rome – about the reign of Messalina and Claudius,Rome
The Pride and the Passion,1957,1807-1814,1807,1814,7,"The Napoleonic Wars, the Peninsular War in Spain",Spain
Messalina,1960,41-48,41,48,7,Rome – about the reign of Messalina and Claudius,Rome
The Miracle Worker,1962,1880-1887,1880,1887,7,"The early childhood of Helen Keller, her infancy contraction of blindness and deafness and Anne Sullivan's arrival","Tuscumbia, AL"
The Man in the Iron Mask,1977,1660-1667,1660,1667,7,Loosely based on the existence of the Man in the Iron Mask. Set in France in the reign of Louis XIV,France
Druids,2001,58-51 BC,-58,-51,7,the struggle between Julius Caesar and Vercingetorix in the Gallic Wars,Rome
Kingdom of Heaven,2005,1183-1190,1183,1190,7,events which led to the Third Crusade (the Battle of Hattin and the Siege of Jerusalem),Jurusalem
Outlander (TV series),2014,1743-ongoing,1743,1750,7,Depicts events leading up to the Jacobite Rising of 1745,England
Wolf Hall,2015,1529-1536,1529,1536,7,The court of Henry VIII of England through the eyes of Thomas Cromwell.,UK
War & Peace,2016,1805-1812,1805,1812,7,The Russian Empire during the Napoleonic era,Russia
The Four Feathers,1939,1882-1888,1882,1888,6,During the British Army's Nile Expedition,Egypt
The Robe,1953,30-36,30,36,6,"Rome – ending reign of Tiberius, the beginning of Caligula",Rome
Shinobi no Mono,1962,1575-1581,1575,1581,6,Based on the novel of the same name.,Japan
Constantine and the Cross,1962,306-312,306,312,6,Rome's first Christian emperor from the death of Constantius Chlorus to the Battle of the Milvian Bridge,Rome
John Wycliffe: The Morning Star,1984,1378-1384,1378,1384,6,"the life and teachings of John Wycliffe, the 14th-century English theologian who is often seen as a fore-runner of the Protestant Reformation",England
Dances with Wolves,1990,1864-1870,1864,1870,6,"Fictional story set during the American Civil War and its aftermath in the American West, interaction with the Lakota Sioux",South Dakota
With Fire and Sword,1999,1648-1654,1648,1654,6,The Khmelnytsky uprising in Ukraine against the control of the Polish–Lithuanian Commonwealth. It led to the period of the Commonwealth known as the Deluge.,Ukraine
The Four Feathers,2002,1882-1888,1882,1888,6,During the British Army's Nile Expedition,Egypt
The Apocalypse,2002,90-96,90,96,6,Rome – Ephesus,Rome
Benedict Arnold: A Question of Honor,2003,1776-1782,1776,1782,6,"Depicting Benedict Arnold, both an early hero of the American Revolution and a notorious defector.",northeastern united states
A Battle of Wits,2006,375-369 BC,-375,-369,6,set in the reign of King Lie of Zhou,China
Detective Dee and the Mystery of the Phantom Flame,2010,684-690,684,690,6,"a Hong Kong film based on a fictional account of Di Renjie, set in the reign of Wu Zetian",China
The Private Lives of Elizabeth and Essex,1939,1596-1601,1596,1601,5,"Elizabeth I of England and Robert Devereux, 2nd Earl of Essex.",England
La Fayette,1961,1776-1781,1776,1781,5,"The film depicts the life of Gilbert du Motier, Marquis de Lafayette, in particular his role in the American War of Independence.",northeastern united states
Sword of the Conqueror,1961,567-572,567,572,5,Alboin and the Lombard invasion of Italy,italy
Shinobi no Mono 3: Resurrection,1963,1595-1600,1595,1600,5,Based on the novel of the same name.,Japan
Saladin,1963,1187-1192,1187,1192,5,events leading up to and including the Third Crusade,"Beirut, Lebanon"
The Enigma of Kaspar Hauser,1974,1828-1833,1828,1833,5,The story of foundling Kaspar Hauser in the German Confederation.,Germany
The Deluge,1974,1655-1660,1655,1660,5,The Polish–Lithuanian Commonwealth during the Second Northern War,Poland
La Revolution française,1989,1789-1794,1789,1794,5,French Revolution,France
The Patriot,2000,1776-1781,1776,1781,5,"Based on the life of Francis Marion, an officer of the Continental Army officer during the American Revolutionary War.",northeastern united states
Elizabeth: The Golden Age,2007,1585-1590,1585,1590,5,The reign of Elizabeth I of England and the Spanish Armada.,England
Katipunan,2013,1892-1897,1892,1897,5,Tells the how the Katipunan was formed from Andres Bonifacio's perspective.,Philippines
Heneral Luna,2015,1898-1903,1898,1903,5,The biography of General Antonio Luna's career up to his assassination during the Philippine–American War.,Philippines
Thugs of Hindostan,2018,1795-1800,1795,1800,5,Based on a band of Thugs resisting the East India Company's rule in India.,India
Esther and the King,1960,486-482 BC,-486,-482,4,the biblical story of Esther,Anshan
The Agony and the Ecstasy,1965,1508-1512,1508,1512,4,The painting of the Sistine Chapel.,Vatican
Caligula,1979,37-41,37,41,4,Rome – the reign of the third emperor,Rome
The Great Conqueror's Concubine,1994,206-202 BC,-206,-202,4,a Hong Kong film set in the Chu–Han Contention,China
Jefferson in Paris,1995,1784-1788,1784,1788,4,"A semi-fictional account of Thomas Jefferson's tenure as the Ambassador of the United States to France before his presidency and of his alleged relationships with British artist Maria Cosway and his slave, Sally Hemings.",Paris
Casanova,2005,1753-1757,1753,1757,4,Giacomo Casanova,France
One Night with the King,2006,486-482 BC,-486,-482,4,the biblical story of Esther set in the Achaemenid Empire,Anshan
The Young Victoria,2009,1836-1840,1836,1840,4,"Early reign of Queen Victoria of the United Kingdom of Great Britain and Ireland and her marriage to Albert, Prince Consort",UK
White Vengeance,2011,206-202 BC,-206,-202,4,loosely based on the Feast at Hong Gate and events in the Chu–Han Contention,China
The Last Supper,2012,206-202 BC,-206,-202,4,based on events in the Chu–Han Contention,China
The English Game,2020,1879-1883,1879,1883,4,early association football in Great Britain,UK
Tiniente Rosario,1937,1898-1901,1898,1901,3,The Story about the Philippine Revolutionary Army and its Female Sergeant officer.[7],Philippines
Sissi – Fateful Years of an Empress,1957,1857-1860,1857,1860,3,Last film in the Sissi trilogy.,Austria
The Mighty Crusaders,1958,1096-1099,1096,1099,3,First Crusade,"Beirut, Lebanon"
Carthage in Flames,1960,149-146 BC,-149,-146,3,Depicts the last of the Punic Wars between the Roman Republic and Carthage.,Italy
Shinobi no Mono 8: Three Enemies,1966,1570-1573,1570,1573,3,,Japan
The Mission,1986,1760-1763,1760,1763,3,Jesuit missionaries in South America,Paraguay 
The Last Temptation of Christ,1988,27-30 AD,27,30,3,Judea – the life of Jesus Christ,bethlehem
Tombstone,1993,1881-1884,1881,1884,3,Events leading up to and following the Gunfight at the O.K. Corral,Tombstone
Ride with the Devil,1999,1861-1864,1861,1864,3,"depicts the activities of pro-Confederate Bushwhackers, guerrilla fighters, in Missouri during the American Civil War",Sicily
Rytsarskiy roman,2000,1096-1099,1096,1099,3,First Crusade,Istanbul
Brotherhood of the Wolf,2001,1764-1767,1764,1767,3,Based on a real-life series of killings that took place in France in the 18th century and on the famous legend of the Beast of Gévaudan,France
The Crusaders,2001,1096-1099,1096,1099,3,First Crusade,"Beirut, Lebanon"
Cold Mountain,2003,1861-1864,1861,1864,3,A couple in North Carolina is separated during the American Civil War and try to find each other again.,North Carolina
Bright Star,2009,1818-1821,1818,1821,3,The last three years of poet John Keats' life,England
All Is True,2018,1613-1616,1613,1616,3,later years in the life of William Shakespeare,England
Outlaw King,2018,1304-1307,1304,1307,3,"Robert the Bruce rebels against Edward I's rule over Scotland, thus becoming an ""outlaw"", depicts the Battle of Loudoun Hill",Scotland
Jamestown,2017,1619-1622,1619,1622,3,"The colonization of Jamestown, Virginia",Virgina
The Crusades,1935,1190-1192,1190,1192,2,About the Third Crusade,"Beirut, Lebanon"
The 47 Ronin,1941,1701-1703,1701,1703,2,Two-part film depicting the famous actions of the Forty-seven r?nin in 1701–1703. Part 2 was released on 1942.02.11.,Japan
Sins of Rome,1953,73-71 BC,-73,-71,2,the Third Servile War in Rome,Italy
Spartacus,1960,73-71 BC,-73,-71,2,the Third Servile War in Rome,Italy
Siege of Syracuse,1960,214-212 BC,-214,-212,2,the Roman Siege of Syracuse during the Second Punic War,"syracuse, italy"
Chushingura,1962,1701-1703,1701,1703,2,Another film about the Forty-seven r?nin.,Japan
Ned Kelly,1970,1878-1880,1878,1880,2,British-Australian biographical film of 19th-century Australian bushranger Ned Kelly,Australia
Robin and Marian,1976,1199-1201,1199,1201,2,from the death of Richard the Lionheart until the early reign of King John,England
Shaolin Temple,1982,619-621,619,621,2,"starring Jet Li, based on the story of Shaolin Temple help Li Shimin",China
Journey of Honor,1991,1600-1602,1600,1602,2,Loosely based on the journey of samurai Hasekura Tsunenaga and his delegation to Spain in 1613.,Japan
Amistad,1997,1839-1841,1839,1841,2,"Mutiny aboard La Amistad, a ship containing slaves from Africa. The ship had left Havana and was bound for Camagüey, both ports being in Spanish Cuba. The film follows the ship's entry into United States custody and the subsequent trial. The case was resolved by the trial United States v. The Amistad.",Cuba
Gods and Generals,2003,1861-1863,1861,1863,2,The American Civil War from the outset of the war to the Battle of Chancellorsville,Eastern US
Master and Commander: The Far Side of the World,2003,1803-1805,1803,1805,2,During the Napoleonic Wars,France
Spartacus,2004,73-71 BC,-73,-71,2,the Third Servile War in Rome,Italy
Gunpowder,2017,1603-1605,1603,1605,2,English Catholic Robert Catesby and the Gunpowder Plot,England
At Eternity's Gate,2018,1888-1890,1888,1890,2,the final years of painter Vincent van Gogh's life,Netherlands
Julius Caesar (many adaptations),1908,44-42 BC,-44,-42,2,Shakespeare's play about the death and aftermath of this famous dictator,Rome
Spartacus,2010,73-71 BC,-73,-71,2,the Third Servile War in Rome,Italy
Caesar and Cleopatra,1945,48-47 BC,-48,-47,1,Egypt during the stay of Julius Caesar,Egypt
The Master of Ballantrae,1953,1745-1746,1745,1746,1,Jacobite Rising of 1745,England
Sissi – The Young Empress,1956,1855-1856,1855,1856,1,Sissi adapts to life as Empress of Austria.,Austria
Princess Sen and Hideyori,1962,1615-1616,1615,1616,1,,Japan
Culloden,1964,1745-1746,1745,1746,1,Jacobite Rising of 1745,England
Shinobi no Mono 4: Siege,1964,1614-1615,1614,1615,1,,Japan
Dacii,1967,86-87,86,87,1,Dacia (modern Romania) – Domitian's Dacian War,Romania
Mayerling,1968,1888-1889,1888,1889,1,"Based on the Mayerling Incident, a series of events leading to the apparent murder–suicide of Crown Prince Rudolf of Austria and his lover Baroness Mary Vetsera.",Austria
The Column,1968,105-106,105,106,1,the Roman emperor Trajan conquering Dacia,Transylvania
Red Lion,1969,1867-1868,1867,1868,1,,Japan
El Santo de la Espada,1970,1821-1822,1821,1822,1,José de San Martín and the Spanish American wars of independence,Chile
Shogun's Samurai,1978,1623-1624,1623,1624,1,,Japan
Samurai Reincarnation,1981,1637-1638,1637,1638,1,,Japan
Masada,1981,72-73,72,73,1,Roman province of Judea during the First Jewish–Roman War,Rome
The Master of Ballantrae,1984,1745-1746,1745,1746,1,Jacobite Rising of 1745,England
Revolution,1985,1776-1777,1776,1777,1,Fictionalized story of the American Revolution in New York,New York
Kivulegedara Mohottala,1987,1817-1818,1817,1818,1,based on freedom fighter Kivulegedara Mohottala and Great Rebellion of 1817–1818,Sri Lanka
Glory,1989,1862-1863,1862,1863,1,The American Civil War from the Battle of Antietam to the Second Battle of Fort Wagner,Eastern US
Chasing the Deer,1994,1745-1746,1745,1746,1,Jacobite Rising of 1745,England
The Crucible,1996,1692-1693,1692,1693,1,Dramatization of the Salem witch trials that took place in Province of Massachusetts Bay,Massachusetts
Ned Kelly,2003,1878-1879,1878,1879,1,Biographical film of Ned Kelly based on the historical novel Our Sunshine,Australia
The Last Samurai,2003,1876-1877,1876,1877,1,"Events in the wake of the Meiji Restoration in the Empire of Japan, 1876–1877",Japan
Colosseum: Rome's Arena of Death,2003,79-80,79,80,1,"tells story of Verus, a gladiator who fought at the Colosseum in Rome.",Rome
The New World,2005,1607-1608,1607,1608,1,"The colonization of Jamestown, Virginia",Virgina
Red Cliff,2008,winter of 208-209,208,209,1,epic war film based on the Battle of Red Cliffs,China
Kerala Varma Pazhassi Raja,2009,1796-1797,1796,1797,1,Life of Pazhassi Raja-an Indian royal resisting the East India Company,India
Nova Zembla,2011,1596-1597,1596,1597,1,"About the last journey of Willem Barentsz and Jacob van Heemskerk, when they and their crew attempted sail to the Indies via Northeast Passage over Russia. They were stranded on the island of Nova Zembla.",Nova Zembla
K?chiyama to Nao-zamurai,1916,0,0,0,0,Based on the play of the same name.,Japan
Nao-zamurai,1922,0,0,0,0,Based on the play of the same name.,Japan
Richard the Lion-Hearted,1923,1190,1190,1190,0,based on Sir Walter Scott's The Talisman and set in the Third Crusade,"Beirut, Lebanon"
Die Nibelungen,1924,450,450,450,0,"about the Germanic hero Siegfried, his murder, and his widow's vengeance",Germany
A Diary of Chuji's Travels,1927,0,0,0,0,Awards: 1 Kinema Junpo Award,Japan
Sword of Penitence,1927,0,0,0,0,,Japan
The Viking,1928,1000,1000,1000,0,Leif Ericson and the expedition to North America,North America
Jobless Samurai,1928,0,0,0,0,Awards: 1 Kinema Junpo Award,Japan
Wara Wara,1930,1535,1535,1535,0,Romance set at the time of the Spanish conquest of Bolivia.,Bolivia
Nao-zamurai,1930,0,0,0,0,Based on the play of the same name.,Japan
Jirokichi the Rat,1931,0,0,0,0,,Japan
The Sign of the Cross,1932,64,64,64,0,Persecution of the Christians immediately after the Great Fire of Rome,Rome
Ch?shingura Zenpen: Ak?ky? no maki,1932,0,0,0,0,,Japan
The Scarlet Pimpernel,1934,1792,1792,1792,0,French Revolution,France
Treasure Island,1934,1750,1750,1750,0,Adaptation of the famous pirate story by Robert Louis Stevenson,Nassau
"Ch?shingura - Ninj?-hen, Fukush?-hen",1934,0,0,0,0,,Japan
Mutiny on the Bounty,1935,1789,1789,1789,0,the Mutiny on the Bounty,Tahiti
Clive of India,1935,1757,1757,1757,0,"Robert Clive, Commander-in-Chief, India and the Battle of Plassey. The Battle was part of the Carnatic Wars.",Palashi
The Million Ryo Pot,1935,0,0,0,0,,Japan
"The Avenging Ghost of Yukinojo, Part 1",1935,0,0,0,0,,Japan
"The Avenging Ghost of Yukinojo, Part 2",1935,0,0,0,0,,Japan
Daibosatsu t?ge: dai-ippen - K?gen itto-ry? no maki,1935,0,0,0,0,,Japan
The Last of the Mohicans,1936,1757,1757,1757,0,French and Indian War,Quebec
Tudor Rose (Nine Days a Queen),1936,1553,1553,1553,0,"About Lady Jane Grey, Queen Regnant of the Kingdom of England for nine days.",England
"The Avenging Ghost of Yukinojo, Part 3",1936,0,0,0,0,,Japan
Daibosatsu t?ge: Suzuka-yama no maki - Mibu Shimabara no maki,1936,0,0,0,0,,Japan
Humanity and Paper Balloons,1937,1700,1700,1700,0,,Japan
Fire Over England,1937,1588,1588,1588,0,The Spanish Armada during the Anglo-Spanish War.,Spain
Ambikapathy,1937,1083,1083,1083,0,"Tamil, a love story set in India in 1083",India
Chikemuri Takadanobaba,1937,0,0,0,0,,Japan
Scipio Africanus: The Defeat of Hannibal,1937,202 BC,-202,-202,0,Battle of Zama which ended the Second Punic War,Tunisia
Alexander Nevsky,1938,1241,1241,1241,0,Prince Alexander Nevsky and the Battle of the Ice,Northeastern Europe
The Adventures of Robin Hood,1938,1190,1190,1190,0,During the life of Richard the Lionheart after his release from captivity in 1194,England
Drums Along the Mohawk,1939,1776,1776,1776,0,"Settlers during the American Revolution. They are raided by a combined force of British, Loyalist, and Indian raiders.",New York
"Chushingura, Part One",1939,1701,1701,1701,0,,Japan
"Chushingura, Part Two",1939,1701,1701,1701,0,,Japan
Singing Lovebirds,1939,0,0,0,0,,Japan
A Color Print of Edo,1939,0,0,0,0,,Japan
Pride and Prejudice,1940,early 1900 ,1813,1813,0,adaptation of Jane Austen's 1813 novel set during the Regency era in Great Britain,UK
Northwest Passage,1940,1757,1757,1757,0,French and Indian War and the ranger campaign of Robert Rogers,Quebec
Sikandar,1941,326 BC,-326,-326,0,Set after Alexander the Great's conquest of Persia and as he pertains to his conquest of the kingdoms of Pauravas.,Jhelum
Day of Wrath,1943,1624,1624,1624,0,"Loosely based on the case of alleged witch Anne Pedersdotter, and using a fictitious witchcraft trial as a metaphor for the then-current Nazi persecution of Jews.","Salem, Massachusetts"
Kikuchi sembon-yari: Shidonî tokubetsu k?geki-tai,1944,0,0,0,0,,Japan
A Tale of Archery at the Sanjusangendo,1945,0,0,0,0,,Japan
Centennial Summer,1946,1876,1876,1876,0,Set in Philadelphia at the time of the Centennial Exposition,Philadelphia
Utamaro and His Five Women,1946,1800,1800,1800,0,,Japan
The Queen's Necklace,1946,1780,1780,1780,0,"Based on the Affair of the Diamond Necklace. Jeanne of Valois-Saint-Rémy, a descendant of the House of Valois and courtesan takes revenge by scamming Marie Antoinette, Cardinal de Rohan, and others. The scandal kindling the flames of the French Revolution.",France
Unconquered,1947,1763,1763,1763,0,Pontiac's War focusing on the Siege of Fort Pitt.,Fort Pitt
Sur?nin makarit?ru,1947,0,0,0,0,,Japan
Macbeth,1948,1050,1050,1050,0,Scottish king Mac Bethad mac Findlaích,Scotland
Hamlet,1948,600,600,600,0,Denmark in the Germanic Heroic Age – adaptation of the Shakespeare play based on the Danish legend of Amleth,Denmark
Eureka Stockade,1949,1854,1854,1854,0,"Peter Lalor and the Eureka Rebellion, a gold miners' rebellion at the Eureka Stockade (Ballarat, Australia).",Ballarat
Fabiola,1949,312,312,312,0,Rome early in the reign of Constantine I,Rome
Tripoli,1950,1805,1805,1805,0,Battle of Derne,Libya
Treasure Island,1950,1750,1750,1750,0,Adaptation of the famous pirate story by Robert Louis Stevenson,Nassau
The Last Days of Pompeii,1950,79,79,79,0,Pompeii in the days leading up to the eruption of Mount Vesuvius,Pompeii
Ore wa yojinbo,1950,0,0,0,0,,Japan
Senritsu,1950,0,0,0,0,,Japan
Wakasama zamurai torimonoch?: nazo no n?men yashiki,1950,0,0,0,0,,Japan
Rashomon,1950,0,0,0,0,,Japan
Captain Horatio Hornblower R.N.,1951,1807,1807,1807,0,The Napoleonic Wars,France
The Golden Horde,1951,0,0,0,0,English-language film about an English knight who leads the defense of Samarkand against Genghis Khan,Uzbekistan
Kanketsu Sasaki Kojir?: Ganry?-jima kett?,1951,0,0,0,0,,Japan
Five Men of Edo,1951,0,0,0,0,,Japan
Ivanhoe,1952,1192,1192,1192,0,adaptation of the novel by Sir Walter Scott about the English knight who returns from the Third Crusade to find that his name has been falsely slandered,England
The Men Who Tread on the Tiger's Tail,1952,1185,1185,1185,0,,Japan
Androcles and the Lion,1952,161,161,161,0,Rome - Based on the 1912 George Bernard Shaw play of the same name.,Rome
Vendetta of a Samurai,1952,0,0,0,0,"Awards: 1 Blue Ribbon Award, 1 Mainichi Film Concours",Japan
The Life of Oharu,1952,0,0,0,0,,Japan
Sword for Hire,1952,0,0,0,0,,Japan
Tsukigata Hanpeita,1952,0,0,0,0,,Japan
Botany Bay,1953,1787,1787,1787,0,"Fictional story about the First Fleet sailing to Botany Bay, New South Wales",Venezuela
Rob Roy: The Highland Rogue,1953,1713,1713,1713,0,Scottish folk hero Robert Roy MacGregor,Scotland
Gate of Hell,1953,1159,1159,1159,0,"Awards: 2 Academy Awards, 1 Golden Leopard, 1 New York Film Critics Circle Award, Palme d'Or,",Japan
Ugetsu Monogatari,1953,0,0,0,0,Based on the novel of the same name.,Japan
Beau Brummell,1954,1795,1795,1795,0,"Beau Brummell, a 19th-century arbiter of fashion in England who popularized the man's suit and necktie",England
Rákóczi hadnagya,1954,1708,1708,1708,0,Adventure movie in Hungary during Rákóczi's War of Independence (1703–11).,Hungary
Samurai I: Musashi Miyamoto,1954,1600,1600,1600,0,Awards: 1 Academy Award,Japan
Seven Samurai,1954,1586,1586,1586,0,"Awards: 2 Jussi Awards, 1 Mainichi Film Award, 1 Silver Lion",Japan
La Reine Margot,1954,1572,1572,1572,0,France during the St. Bartholomew's Day massacre. The massacre was part of the French Wars of Religion.,France
King Richard and the Crusaders,1954,1191,1191,1191,0,"While leading the Third Crusade, King Richard Lionheart battles treachery in his own camp as well as the Saracens and their charismatic leader Saladin.","Beirut, Lebanon"
Demetrius and the Gladiators,1954,41,41,41,0,Ancient Rome – the end Caligula reign,Rome
Ak? gishi,1954,0,0,0,0,,Japan
The Crucified Lovers,1954,0,0,0,0,Awards: 1 Blue Ribbon Award,Japan
The Playful Fox and the Thousand Cherry Trees,1954,0,0,0,0,,Japan
Queen of Babylon,1954,600 BC,-600,-600,0,"Set in the Neo-Babylonian Empire, depicts Semiramis as a Babylonian queen.",Hillah
The Egyptian,1954,1350 BC,-1350,-1350,0,"Based on the novel The Egyptian by Mika Waltari, who adapted the Story of Sinuhe. The film mentions the pharaoh Akhenaten, the Hittite Empire, and iron technology.",Egypt
Sissi,1955,1854,1854,1854,0,"It is the first installment in the trilogy of films about Empress Elisabeth of Austria, nicknamed Sissi.",Austria
The Dark Avenger,1955,1359,1359,1359,0,"Edward, the Black Prince",England
Tower of Lust,1955,1314,1314,1314,0,"Margaret of Burgundy, Queen of France",France
Lady Godiva of Coventry,1955,1050,1050,1050,0,an English noble woman who allegedly rode naked through the streets of Coventry in protest of unfair taxation,England
Samurai II: Duel at Ichijoji Temple,1955,0,0,0,0,,Japan
The Lone Journey,1955,0,0,0,0,,Japan
Tales of the Taira Clan,1955,0,0,0,0,Awards: 1 Mainichi Film Concours,Japan
"Ak? R?shi: Ten no Maki, Chi no Maki",1956,1701,1701,1701,0,,Japan
Roland the Mighty,1956,778,778,778,0,"Roland, a knight of Charlemagne's court who was killed at the Battle of Roncevaux Pass",France
Samurai III: Duel at Ganryu Island,1956,0,0,0,0,,Japan
Ghost of Hanging in Utusunomiya,1956,0,0,0,0,,Japan
Dandy Sashichi Detective Story: Six Famous Beauties,1956,0,0,0,0,,Japan
The Seventh Seal,1957,1351,1351,1351,0,During the initial outbreak of the plague,Sweden
Throne of Blood,1957,0,0,0,0,,Japan
The Lord Takes a Bride,1957,0,0,0,0,,Japan
Yagyu Secret Scrolls,1957,0,0,0,0,,Japan
Akad? Suzunosuke: Tsukiyo no kaijin,1957,0,0,0,0,,Japan
Adauchi s?zenji baba,1957,0,0,0,0,,Japan
Souls in the Moonlight,1957,0,0,0,0,Awards: 1 Mainichi Film Concours,Japan
A Matter of Valor,1957,0,0,0,0,,Japan
Akad? Suzunosuke: Shingetsu-to no y?ki,1957,0,0,0,0,,Japan
The Prodigal Son,1957,0,0,0,0,,Japan
Demon Crusader,1957,0,0,0,0,Based on the novel of the same name.,Japan
The Idle Vassal: House of the Snake Princess,1957,0,0,0,0,,Japan
The Barbarian and the Geisha,1958,1856,1856,1856,0,,Japan
The Vikings,1958,860,860,860,0,highly fictionalized account of the death of Ragnar Lodbrok and the subsequent invasion of Northumbria by two of his sons,England
"Yagyu Secret Scrolls, Part II",1958,0,0,0,0,,Japan
Chushingura,1958,0,0,0,0,,Japan
Suzunosuke Akado: The Birdman with Three Eyes,1958,0,0,0,0,,Japan
Detective Hibari: Case of the Golden Hairpins,1958,0,0,0,0,,Japan
The Ballad of Narayama,1958,0,0,0,0,"Awards: 3 Kinema Junpo Awards, 3 Mainichi Film Concours",Japan
The 7th Secret Courier for Edo,1958,0,0,0,0,,Japan
The Hidden Fortress,1958,0,0,0,0,Awards: 1 Silver Bear Award,Japan
Goliath and the Barbarians,1959,568,568,568,0,the Lombard invasion of Italy,italy
The Last Days of Pompeii,1959,79,79,79,0,Pompeii in the days leading up to the eruption of Mount Vesuvius,Pompeii
Life of an Expert Swordsman,1959,0,0,0,0,,Japan
Hawk of the North,1959,0,0,0,0,,Japan
The Ghost of Yotsuya,1959,0,0,0,0,,Japan
Kager? Ezu,1959,0,0,0,0,,Japan
The Giant of Marathon,1959,490 BC,-490,-490,0,Greece: Battle of Marathon,"Marathon, Greece"
The Alamo,1960,1836,1836,1836,0,Battle of the Alamo during the Texas Revolution.,San Antonio
Austerlitz (1960 film),1960,1805,1805,1805,0,Portrays Napoleon in this film about his victory at the Battle of Austerlitz,Slavkov u Brna
Mughal-e-Azam,1960,1570/1580,1570,1570,0,"Set during the Mughal Empire, depicting fictional conflict between King Akbar and his son Crown Prince Salim over semi fictional courtesan Anarkali whose historical existence is very unlikely.",Agra
The Virgin Spring,1960,late 1300 ,1390,1390,0,"adaptation of the 13th century Swedish ballad, Töres döttrar i Wänge",Sweden
Revenge of the Barbarians,1960,410,410,410,0,the Visigothic sack of Rome,Rome
Shinsengumi: Last Days of the Shogunate,1960,0,0,0,0,,Japan
Revak the Rebel,1960,218 BC,-218,-218,0,Iberian Peninsula immediately before the Second Punic War,Iberian Peninsula
The Pharaohs' Woman,1960,3100 BC,-3100,-3100,0,"A beautiful girl and a young physician fall in love in the midst of a family, and power struggle between rival princes of Upper and Lower Egypt. Set shortly after the unification of Upper Egypt and Lower Egypt by the First Dynasty of Egypt.",Egypt
Yojimbo,1961,1860,1860,1860,0,,Japan
The Story of Osaka Castle,1961,0,0,0,0,,Japan
Samurai Hawk,1961,0,0,0,0,,Japan
Ak? R?shi,1961,0,0,0,0,,Japan
Miyamoto Musashi,1961,0,0,0,0,,Japan
Hangyakuji,1961,0,0,0,0,"Awards: 1 Blue Ribbon Award, 1 Mainichi Film Concours",Japan
The Centurion,1961,146 BC,-146,-146,0,Battle of Corinth between Rome and the Achaean League,Italy
The Colossus of Rhodes,1961,280 BC,-280,-280,0,Fictional account of the island of Rhodes during its Classical period in the late third century before coming under Roman control,Rhodes
Damon and Pythias,1961,400 BC,-400,-400,0,"Syracuse, Sicily","syracuse, italy"
The 300 Spartans,1961,480 BC,-480,-480,0,"Greece: Battle of Thermopylae, Greece","Thermopylae, Greece"
Duel of Champions,1961,650 BC,-650,-650,0,"Based on the Roman legend of the Horatii, set in the reign of Tullus Hostilius. The Roman Kingdom is at war with the city of Alba Longa and the outcome will by decided by champion warfare. Rome sends three brothers from gens Horatia and Alba Longa sends three brothers from gens Curiatia gens. Publius Horatius emerges as the sole survivor of the combat, and Alba Longa is annexed by the Roman Kingdom.",Rome
Romulus and the Sabines,1961,750 BC,-750,-750,0,"Based on the Rape of the Sabine Women, an origin myth for the Roman Kingdom. Shortly after the founding of the kingdom and the start of the reign of Romulus, Rome still lacks a female population and its residents can not reproduce. Romulus organizes bride kidnappings from neighboring people, primarily targeting the Sabines. This leads to a war between the Roman and Sabines, and the eventual assimilation of the Sabines by the Romans.",Rome
Duel of the Titans,1961,753 BC,-753,-753,0,"Based on the story of Romulus and Remus, and the founding of the city of Rome and the Roman Kingdom.",Rome
Mutiny on the Bounty,1962,1789,1789,1789,0,the Mutiny on the Bounty,Tahiti
Attack of the Normans,1962,early 900 ,900,900,0,"set in England during the Viking Age (""Normans"" in the title being used in its original continental sense, meaning ""Vikings"")",England
Pontius Pilate,1962,33 AD,33,33,0,Judea – The events surrounding the Passion of Jesus Christ focusing on Pontius Pilate.,Jerusalem
Sanjuro,1962,0,0,0,0,Sequel to the 1961 film Yojimbo.,Japan
In Search of Mother,1962,0,0,0,0,,Japan
"Shiro Amakusa, the Christian Rebel",1962,0,0,0,0,,Japan
The Tale of Zatoichi,1962,0,0,0,0,,Japan
The Tale of Zatoichi Continues,1962,0,0,0,0,,Japan
Miyamoto Musashi: Showdown at Hannyazaka Heights,1962,0,0,0,0,,Japan
The Slave,1962,48 BC,-48,-48,0,Unofficial sequel to Stanley Kubrick's 1960 film Spartacus,Italy
A Queen for Caesar,1962,48 BC,-48,-48,0,Egypt leading up to the arrival of Julius Caesar,Rome
Julius Caesar Against the Pirates,1962,75 BC,-75,-75,0,loosely based on actual events from the early life of Julius Caesar.,Rome
War Gods of Babylon,1962,627 BC,-627,-627,0,"Set in the Neo-Assyrian Empire; focusing largely on Sardanapalus (probably the Greek name for Ashurbanipal, but anachronistically including Zoroaster (11th–10th century BC) and Hammurabi (1792–1750 BC).",Hillah
The Rape of the Sabine Women,1962,750 BC,-750,-750,0,Adaptation of the Roman foundation myth about the abduction of Sabine women by the Romans shortly after the foundation of the city of Rome.,Rome
Sodom and Gomorrah,1962,2100 BC,-2100,-2100,0,An epic film which is loosely based on the tale of the cities Sodom and Gomorrah in the Book of Genesis.,Israel
Kings of the Sun,1963,1300,1300,1300,0,"On the coast of the Gulf of Mexico, the Native American tribe of chief Black Eagle clashes with the Mayan tribe of King Balam",Mexico
The Fall of Rome,1963,337,337,337,0,Rome based on the persecution of Christians after the death of Emperor Constantine,Rome
Shinsengumi Chronicles,1963,0,0,0,0,,Japan
An Actor's Revenge,1963,0,0,0,0,Remake of the 1935 film An Actor's Revenge.,Japan
Escape from Hell,1963,0,0,0,0,,Japan
The New Tale of Zatoichi,1963,0,0,0,0,,Japan
Sengoku Yaro,1963,0,0,0,0,,Japan
Castle of Owls,1963,0,0,0,0,,Japan
Cruel Tales of Bushido,1963,0,0,0,0,,Japan
Bloody Record of the Shinsengumi,1963,0,0,0,0,,Japan
Brave Records of the Sanada Clan,1963,0,0,0,0,,Japan
Seventeen Ninja,1963,0,0,0,0,,Japan
Zatoichi the Fugitive,1963,0,0,0,0,,Japan
Miyamoto Musashi: The Duel Against Yagyu,1963,0,0,0,0,,Japan
The Great Bandit,1963,0,0,0,0,,Japan
Sleepy Eyes of Death: The Chinese Jade,1963,0,0,0,0,,Japan
Zatoichi on the Road,1963,0,0,0,0,,Japan
Thirteen Assassins,1963,0,0,0,0,,Japan
"Brennus, Enemy of Rome",1963,387 BC,-387,-387,0,the Gallic sack of Rome,Rome
The Beast of Babylon Against the Son of Hercules,1963,539 BC,-539,-539,0,"A fictionalized account of the downfall of the Neo-Babylonian Empire and its conquest by the Achaemenid Empire under the Cyrus the Great. The cruel Balthazar (Belshazzar) has usurped the Babylonian throne and rules through state terrorism. He systematically offers young women as human sacrifice to his gods. Nippur, a descendant of former king Sargon II, fails to stop the usurper on his own. His life is saved by Zairus (Cyrus the Great) and he agrees to help the Persian king in his campaign to conquer Babylon. The historical Belshazzar was a son of king Nabonidus and served as a regent in his father's absence, but never became a king in his own right. During Cyrus' conquest, Nabonidus was captured and his life apparently spared, but Belshazzar may have died during the fall of the city.[1]",Hillah
I Am Semiramis,1963,810 BC,-810,-810,0,"Set in the Neo-Assyrian Empire, during the reign of semi-legendary queen Semiramis. The legends are in part based on the historical Shammuramat, queen consort of Shamshi-Adad V and regent for her son Adad-nirari III.",Hillah
Jason and the Argonauts,1963,1300 BC,-1300,-1300,0,"The story of Jason and Argonauts, a band of heroes in Greek mythology, who in the years before the Trojan War (around 1300 BC) accompanied Jason to Colchis in his quest to find the Golden Fleece.",Hisarlik
Zulu,1964,1879,1879,1879,0,The Battle of Rorke's Drift during the Anglo-Zulu War,South Africa
Shinobi no Mono 5: Mist Saizo Returns,1964,1616,1616,1616,0,,Japan
The Third Ninja,1964,1572,1572,1572,0,,Japan
Hamlet,1964,600,600,600,0,Denmark in the Germanic Heroic Age – this is a Russian adaptation of the Shakespeare play based on the Danish legend of Amleth,Denmark
Revolt of the Praetorians,1964,96,96,96,0,Rome – the assassination of Domitian,Rome
Miyamoto Musashi: The Duel at Ichijoji,1964,0,0,0,0,,Japan
Sleepy Eyes of Death: Sword of Adventure,1964,0,0,0,0,,Japan
Warrior of the Wind,1964,0,0,0,0,,Japan
Zatoichi and the Chest of Gold,1964,0,0,0,0,,Japan
Three Outlaw Samurai,1964,0,0,0,0,,Japan
Sleepy Eyes of Death: Full Circle Killing,1964,0,0,0,0,,Japan
Assassination,1964,0,0,0,0,,Japan
Sleepy Eyes of Death: Sword of Seduction,1964,0,0,0,0,,Japan
"Fight, Zatoichi, Fight",1964,0,0,0,0,,Japan
Adauchi,1964,0,0,0,0,,Japan
Onibaba,1964,0,0,0,0,,Japan
The Scarlet Camellia,1964,0,0,0,0,Awards: 1 Blue Ribbon Award,Japan
Adventures of Zatoichi,1964,0,0,0,0,,Japan
Bakumatsu zankoku monogatari,1964,0,0,0,0,Awards: 1 Blue Ribbon Award,Japan
Giants of Rome,1964,52 BC,-52,-52,0,The film involves a group of soldiers infiltrating the enemy's stronghold to locate and destroy a secret weapon prior to the Battle of Alesia.,Rome
Coriolanus: Hero without a Country,1964,493 BC,-493,-493,0,"The Roman legend of Gaius Marcius Coriolanus. Coriolanus is a Roman general who distinguishes himself in a war between the Roman Republic and the Volsci. When the aristocratic Coriolanus proposes political reforms which will severely reduce the rights of the plebs, most of the Romans turn against him and he is exiled. The vengeful Coriolanus offers his military services to the Volsci, and leads an invasion army against Rome. Coriolanus refuses requests for a peaceful resolution by his former countrymen, but changes his mind when the Romans send his own mother and his wife as their representatives.",Rome
Hero of Rome,1964,509 BC,-509,-509,0,"The story combines the Roman legends of Gaius Mucius Scaevola and the expulsion of king Lucius Tarquinius Superbus. In the film, Lucius Tarquinius Superbus has already been deposed, and the Roman Kingdom has been replaced by a Roman Republic. Lars Porsena, King of Clusium wages war against the Republic in an attempt to restore his ally Tarquinius to the throne. The Roman Senate offers the military leadership to Gaius Mucius Scaevola, a recently released prisoner of war whose right hand is permanently disabled. Scaevola trains himself to fight with his left hand, and leads his troops to victory against Lars Porsena.",Rome
Samurai Assassin,1965,0,0,0,0,,Japan
Kwaidan,1965,0,0,0,0,,Japan
Sleepy Eyes of Death: Sword of Fire,1965,0,0,0,0,,Japan
Red Beard,1965,0,0,0,0,,Japan
Zatoichi's Revenge,1965,0,0,0,0,,Japan
Sleepy Eyes of Death: Sword of Satan,1965,0,0,0,0,,Japan
Samurai Spy,1965,0,0,0,0,,Japan
Muh?matsu no issh?,1965,0,0,0,0,,Japan
Yotsuya Kaidan,1965,0,0,0,0,,Japan
Miyamoto Musashi: Musashi vs. Kojiro,1965,0,0,0,0,,Japan
Zatoichi and the Doomed Man,1965,0,0,0,0,,Japan
Sword of the Beast,1965,0,0,0,0,,Japan
Akuto,1965,0,0,0,0,,Japan
Zatoichi and the Chess Expert,1965,0,0,0,0,,Japan
Khartoum,1966,1884,1884,1884,0,Charles George Gordon defense of the Sudanese city of Khartoum from the forces of the army of Muhammad Ahmad during the Siege of Khartoum. Muhammad Ahmad had proclaimed himself to be the Mahdi.,Khartoum
"The Good, the Bad and the Ugly",1966,1862,1862,1862,0,Two bounty hunters in an uneasy alliance against a third attempt to find a stash of hidden Confederate gold in New Mexico in the middle of the chaos of the American Civil War,New Mexico
Shinobi no Mono 7: Mist Saizo Strikes Back,1966,1616,1616,1616,0,,Japan
The Sword of Doom,1966,0,0,0,0,Based on the novel of the same name.,Japan
Sleepy Eyes of Death: The Mask of the Princess,1966,0,0,0,0,,Japan
Kutsukake Tokijiro: Yukyo Ippiki,1966,0,0,0,0,,Japan
Daimajin,1966,0,0,0,0,,Japan
Zatoichi's Vengeance,1966,0,0,0,0,,Japan
Zatoichi's Pilgrimage,1966,0,0,0,0,,Japan
Sleepy Eyes of Death: Sword of Villainy,1966,0,0,0,0,,Japan
Samurai Wolf,1966,0,0,0,0,,Japan
The Blazing Sword,1966,0,0,0,0,,Japan
The Magic Serpent,1966,0,0,0,0,,Japan
Amrapali,1966,500 BC,-500,-500,0,Based on the life of Ambapali in India,
Pharaoh,1966,1069 BC,-1069,-1069,0,"Set in Ancient Egypt during the reign of a fictitious king ""Ramses XIII"" (there were only 11 kings by that name). The film is based on the novel Pharaoh by Boles?aw Prus, and depicts the final years of the historical Twentieth Dynasty of Egypt. Ramses XIII rises to the throne when still in his 20s, following the deaths of his father, and the incapacitating illnesses and (one suicide) of a number of older brothers. Egypt is in decline due to a combination of internal and external threats, and Ramses is pushing for necessary reforms but his efforts are resisted by the powerful, bureaucratic priesthood. Ramses dies young, before accomplishing his goals. His political rival ""Herhor"" (the historical Herihor) succeeds him on the throne and attempts some of the same reforms, but still fails to rescue Egypt from its decline.",Egypt
Viy,1967,1600,1600,1600,0,"Soviet horror film set in 16th century Ukraine, based on the story of the same name by Nikolai Gogol.",Ukraine
The Testament of Aga Koppanyi,1967,1586,1586,1586,0,"Hungarian adventure film based on the eponymous novel by István Fekete. It talks about the adventourous life of the Hungarian soldiers in the Ottoman Hungary, during the Ottoman–Hungarian wars.",Hungary
Hagbard and Signe,1967,500,500,500,0,Denmark during the Germanic Heroic Age,Denmark
The Viking Queen,1967,60,60,60,0,Britain – loosely based on the revolt of Boudica,UK
Massacre in the Black Forest,1967,9 AD,9,9,0,"Germany – The Battle of the Teutoburg Forest, where the Cherusci ambushed and annihilated three Roman legions.",Romania
Band of Ninja,1967,0,0,0,0,,Japan
Bakumatsu: Tenamonya daiz?d?,1967,0,0,0,0,,Japan
Samurai Wolf II,1967,0,0,0,0,,Japan
Samurai Rebellion,1967,0,0,0,0,,Japan
Sleepy Eyes of Death: A Trail of Traps,1967,0,0,0,0,,Japan
Zatoichi the Outlaw,1967,0,0,0,0,,Japan
Zenigata Heiji,1967,0,0,0,0,,Japan
The Wife of Seishu Hanaoka,1967,0,0,0,0,Based on the novel of the same name.,Japan
Eleven Samurai,1967,0,0,0,0,,Japan
Zatoichi Challenged,1967,0,0,0,0,,Japan
The Silent Stranger,1968,1865,1865,1865,0,,Japan
The Charge of the Light Brigade,1968,1854,1854,1854,0,The disaster of the Crimean War known as the Charge of the Light Brigade. It took place within the Battle of Balaclava.,Balaklava
Colonel Wolodyjowski,1968,1668,1668,1668,0,"The Ottoman invasion of the Polish–Lithuanian Commonwealth, part of the Polish–Ottoman Wars.",Poland
Witchfinder General,1968,1640,1640,1640,0,"Set during the English Civil War. A fictionalized depiction of Matthew Hopkins, a witch-hunter.",England
Stars of Eger,1968,1552,1552,1552,0,"During the Ottoman–Hungarian wars, after the Ottomans have taken Buda, the Hungarian Capital (in 1541), the siege of Eger (1552).",Budapest
The Saga of Tanegashima,1968,1543,1543,1543,0,,Japan
Valley of the Bees,1968,1300,1300,1300,0,The film follows a young man who's sent to join Teutonic order by his father.,Kingdom of Bohemia
Gates to Paradise,1968,1212,1212,1212,0,the ill-fated Children's Crusade,France
The Lion in Winter,1968,1183,1183,1183,0,Henry II is in power as his wife Eleanor of Aquitaine plots with their sons,England
Sleepy Eyes of Death: Hell Is a Woman,1968,0,0,0,0,,Japan
Kuroneko,1968,0,0,0,0,Awards: 2 Mainichi Film Concours,Japan
Sleepy Eyes of Death: In the Spider's Lair,1968,0,0,0,0,,Japan
Botan D?r?,1968,0,0,0,0,Based on the short story of the same name.,Japan
Kill!,1968,0,0,0,0,,Japan
"Krakatoa, East of Java",1969,1883,1883,1883,0,"Nominated for Academy Award for Best Visual Effects, featured the 1883 eruption of the volcano on the island of Krakatoa.",Indonesia
The Royal Hunt of the Sun,1969,1532,1532,1532,0,"Francisco Pizarro's capture of Atahualpa, Sapa Inca.",Peru
A Walk with Love and Death,1969,1358,1358,1358,0,Angelica Huston in the turmoil of the Jacquerie,France
Sleepy Eyes of Death: Castle Menagerie,1969,0,0,0,0,,Japan
Samurai Banners,1969,0,0,0,0,,Japan
"Crimson Bat, the Blind Swordswoman",1969,0,0,0,0,,Japan
Goyokin,1969,0,0,0,0,Awards: 2 Mainichi Film Concours,Japan
Double Suicide,1969,0,0,0,0,Based on the play of the same name.,Japan
The Devil's Temple,1969,0,0,0,0,,Japan
Hitokiri,1969,0,0,0,0,,Japan
Portrait of Hell,1969,0,0,0,0,,Japan
Tengu-to,1969,0,0,0,0,,Japan
Shinsengumi,1969,0,0,0,0,,Japan
The Fort of Death,1969,0,0,0,0,,Japan
"Waterloo, Belgium",1970,1815,1815,1815,0,Battle of Waterloo during the Napoleonic Wars.,"Waterloo, Belgium"
Mission: Iron Castle,1970,1582,1582,1582,0,,Japan
Judgement,1970,1514,1514,1514,0,"Rebellion of György Dózsa, Hungary.",Hungary
The Heroic Ones,1970,880,880,880,0,a Hong Kong film about Li Keyong's generals,China
Zatoichi meets Yojimbo,1970,0,0,0,0,,Japan
Bakumatsu,1970,0,0,0,0,,Japan
The Ambush: Incident at Blood Pass,1970,0,0,0,0,,Japan
Zatoichi Goes to the Fire Festival,1970,0,0,0,0,,Japan
The Emigrants,1971,1840,1840,1840,0,The Swedish immigrants in Minnesota,Minnesota
Persuasion,1971,early 1900 ,1817,1817,0,adaptation of Jane Austen's 1817 novel set during the Regency era in Great Britain,UK
Sense and Sensibility,1971,early 1900 ,1811,1811,0,adaptation of Jane Austen's 1811 novel set during the Regency era in Great Britain,UK
Silence,1971,1638,1638,1638,0,Based on the novel of the same name.,Japan
The Devils,1971,1634,1634,1634,0,"The life and trial of Urbain Grandier, who was convicted of witchcraft and burned. He was blamed for the Loudun possessions.",France
The Decameron,1971,1348,1348,1348,0,based on the novel Il Decameron by Giovanni Boccaccio.,Italy
Macbeth,1971,1050,1050,1050,0,Scottish king Mac Bethad mac Findlaích,Scotland
Zatoichi Meets the One-Armed Swordsman,1971,0,0,0,0,Awards: 1 Mainichi Film Concours,Japan
Miyamoto Musashi: Swords of Death,1971,0,0,0,0,Awards: 1 Golden Charybdis,Japan
En toiu onna,1971,0,0,0,0,,Japan
Inochi b? ni fur? (Inn of Evil),1971,0,0,0,0,"Awards: 5 Mainichi Film Concours, 1 Taormina International Film Festival Award",Japan
Scipio the African,1971,185 BC,-185,-185,0,About the later life of Scipio.,Rome
Socrates,1971,399 BC,-399,-399,0,A false accusation leads the philosopher Socrates to trial and condemnation in 5th century BC Athens.,Athens
Emma,1972,early 1900 ,1815,1815,0,adaptation of Jane Austen's 1815 novel set during the Regency era in Great Britain,UK
1776,1972,1776,1776,1776,0,A musical retelling of the American Revolution's political struggle in the Continental Congress to declare independence.,northeastern united states
Treasure Island,1972,1750,1750,1750,0,Adaptation of the famous pirate story by Robert Louis Stevenson,Nassau
Lone Wolf and Cub: Sword of Vengeance,1972,1655,1655,1655,0,,Japan
"Aguirre, the Wrath of God",1972,1560,1560,1560,0,Lope de Aguirre's ill-fated expedition down the Amazon in search of El Dorado.,Peru
The Canterbury Tales,1972,late 1400 ,1490,1490,0,Based on the medieval narrative poem The Canterbury Tales by Geoffrey Chaucer.,England
The 14 Amazons,1972,1030,1030,1030,0,a Hong Kong film about the Genearals of the Yang Family legends,China
Pope Joan,1972,900-11th ,950,950,0,Fictitious medieval legend of a woman who disguised herself as a man and rose to the status of Pope in the Middle Ages.,France
Trilogy of Swordsmanship (Part 2: The Tigress),1972,860,860,860,0,a Hong Kong film (only Part 2) set during Pang Xun's rebellion,China
Zatoichi at Large,1972,0,0,0,0,Awards: 1 Mainichi Film Concours,Japan
Lone Wolf and Cub: Baby Cart at the River Styx,1972,0,0,0,0,,Japan
Lone Wolf and Cub: Baby Cart to Hades,1972,0,0,0,0,,Japan
Shadow Hunters,1972,0,0,0,0,Based on the manga series of the same name.,Japan
Kogarashi Monjir?,1972,0,0,0,0,,Japan
Zatoichi in Desperation,1972,0,0,0,0,,Japan
Kogarashi Monjir?: kakawari gozansen,1972,0,0,0,0,,Japan
Shadow Hunters 2: Echo of Destiny,1972,0,0,0,0,Based on the manga series of the same name.,Japan
Lone Wolf and Cub: Baby Cart in Peril,1972,0,0,0,0,,Japan
Hanzo the Razor: Sword of Justice,1972,0,0,0,0,,Japan
Bhakta Tukaram,1973,1600,1600,1600,0,Based on the life of Marathi poet and saint Tukaram,India
Hanzo the Razor: The Snare,1973,0,0,0,0,,Japan
Lone Wolf and Cub: Baby Cart in the Land of Demons,1973,0,0,0,0,,Japan
Gniazdo,1974,972,972,972,0,about Mieszko I of Poland,Poland
The God King,1974,473,473,473,0,based on the historical clash between brothers Kasyapa and Moggalana on Sigiriya Rock,Sri Lanka
Hanzo the Razor: Who's Got the Gold?,1974,0,0,0,0,,Japan
Lone Wolf and Cub: White Heaven in Hell,1974,0,0,0,0,,Japan
Ryoma Ansatsu,1974,0,0,0,0,,Japan
Quanto è bello lu murire acciso,1976,1857,1857,1857,0,Failed rising organized by Carlo Pisacane in the Kingdom of the Two Sicilies,Sicilly
General Stone,1976,880,880,880,0,a Hong Kong film about Li Cunxiao,China
Sebastiane,1976,288,288,288,0,Rome Low-budget homo-erotic film about Saint Sebastian,Rome
Shatranj Ke Khiladi,1977,1856,1856,1856,0,Entailing the East India Company's annexation of the kingdom of Oudh (Awadh) from Wajid Ali Shah in 1856 on the eve of the Sepoy Mutiny.,India
Joseph Andrew,1977,1742,1742,1742,0,An adaption of the novel Joseph Andrews by Henry Fielding.,England
Chanakya Chandragupta,1977,3rd  BC,-250,-250,0,Based on the lives of Maurya Emperor Chandragupta Maurya and his mentor Chanakya,India
Junoon,1978,1857,1857,1857,0,About a love story between one of the Rebels of 1857 in Rohilkhand and an Anglo-Indian woman that he has held hostage (along with her mother and grandmother).,India
80 Hussars,1978,1848,1848,1848,0,Hungarian movie about the 1848–49 Revolution and War of Freedom in Hungary. Under the leadership of Farkas Paál a small Hussar troupe escapes from Poland to Hungary to join the Independence war against the Habsburgs. Their adventurous journey is full of thousands of dangers.,Hungary
The Love Suicides at Sonezaki,1978,0,0,0,0,Based on the play of the same name.,Japan
Bandits vs. Samurai Squadron,1978,0,0,0,0,,Japan
Swords of Vengeance: The Fall of Ako Castle,1978,0,0,0,0,,Japan
Zulu Dawn,1979,1879,1879,1879,0,The Battle of Isandlwana during the Anglo-Zulu War,South Africa
Hunter in the Dark,1979,0,0,0,0,Awards: 1 Japanese Academy Award,Japan
The Shogun Assassins,1979,0,0,0,0,Awards: 1 Japanese Academy Award,Japan
G.I. Samurai,1979,0,0,0,0,Time Travel film.,Japan
Heaven's Gate,1980,1892,1892,1892,0,Covers the Johnson County War,Wyoming
Dead or Alive,1980,1851,1851,1851,0,Hungarian movie which talks about the failed assassination by Gáspár Noszlopy on Franz Joseph I of Austria,Hungary
Pride and Prejudice,1980,early 1900 ,1813,1813,0,adaptation of Jane Austen's 1813 novel set during the Regency era in Great Britain,UK
Sh?gun,1980,1600-,1600,1600,0,"Miniseries adaptation of the novel by James Clavell, which is loosely based on the adventures of English navigator William Adams, who journeyed to Japan in 1600 and rose to high rank in the service of the sh?gun.",Japan
Sh?gun,1980,1600,1600,1600,0,"American TV mini-series based on the novel by James Clavell, loosely based on William Adams, the English navigator who served as a key advisor to Tokugawa Ieyasu beginning in 1600.",Japan
Kagemusha,1980,0,0,0,0,"Awards: 2 BAFTA Awards, 1 César Award, 2 David di Donatello Awards, 1 Palme d'Or",Japan
Tokugawa ichizoku no h?kai,1980,0,0,0,0,,Japan
Shogun Assassin,1980,0,0,0,0,English dubbed edit/compilation of the first two 1972 Lone Wolf and Cub films.,Japan
Shogun's Ninja,1980,0,0,0,0,,Japan
The Cantabrians,1980,29 BC,-29,-29,0,About the Cantabrian Wars during the final stage of the two-century long Roman conquest of Hispania.,Iberian Peninsula
The Bushido Blade,1981,1854,1854,1854,0,About the forced Opening of Japan in 1854.,Japan
Sense and Sensibility,1981,early 1900 ,1811,1811,0,adaptation of Jane Austen's 1811 novel set during the Regency era in Great Britain,UK
Útlaginn,1981,900,900,900,0,Adaptation of the saga of Gisli Sursson,Iceland
Lovespell,1981,600,600,600,0,Britain and Ireland – adaptation of the Brythonic legend of Tristan and Iseult,Ireland
Grendel Grendel Grendel,1981,600,600,600,0,"animated film based on the 1971 novel Grendel, retelling the Anglo-Saxon poem from the monster's perspective",Denmark
Sekigahara,1981,0,0,0,0,Japanese TV mini-series that aired over 3 consecutive nights.,Japan
Kazunomiya-sama otome,1981,0,0,0,0,Television film,Japan
Eijanaika,1981,0,0,0,0,,Japan
Shikake-nin Baian,1981,0,0,0,0,,Japan
Edo Porn,1981,0,0,0,0,"Awards: 1 Blue Ribbon Award, 1 Hochi Film Award, 2 Japanese Academy Awards, 1 Yokohama Film Festival Award",Japan
Quest for Fire,1981,"80,000 BC",-80000,-80000,0,"The story is set in Paleolithic Europe, with its plot surrounding the struggle for control of fire by early humans.",Europe
The Scarlet Pimpernel,1982,1792,1792,1792,0,French Revolution,France
The Draughtsman's Contract,1982,1694,1694,1694,0,Set during the reign of William III and Mary II in England.,England
Fire and Sword,1982,600,600,600,0,Britain and Ireland – adaptation of the Brythonic legend of Tristan and Iseult,Ireland
Ninja Wars,1982,0,0,0,0,Awards: 3 Japanese Academy Awards,Japan
Mansfield Park,1983,early 1900 ,1814,1814,0,adaptation of Jane Austen's 1814 novel set during the Regency era in Great Britain,UK
Danton,1983,1794,1794,1794,0,Conflict between Georges Danton and Maximilien Robespierre during the French Revolution.,France
Banovi? Strahinja,1983,1389,1389,1389,0,a battle between Medieval Serbia and the Ottoman Empire,Serbia
The Eight Diagram Pole Fighter,1983,980,980,980,0,a Hong Kong film about the Generals of the Yang Family legends,China
All the King's Men,1983,950,950,950,0,a Taiwanese film about Chai Rong's last days,China
The Ballad of Narayama,1983,0,0,0,0,"Awards: 1 Blue Ribbon Award, 1 Hochi Film Award, 3 Japanese Academy Awards, 2 Mainichi Film Concours, 1 Palme d'Or",Japan
Legend of the Eight Samurai,1983,0,0,0,0,,Japan
Flowers of Reverie,1984,1849,1849,1849,0,Hungarian movie which talks about the time after the defeat of the Hungarian Revolution of 1848 and the Surrender at Világos,Hungary
The Bounty,1984,1789,1789,1789,0,The Mutiny on the Bounty,Tahiti
Generals of the Yang Family,1984,980,980,980,0,a Chinese film about the Generals of the Yang Family legends,China
When the Raven Flies,1984,897,897,897,0,Set in the Viking Age,Iceland
Hissatsu!,1984,0,0,0,0,"Awards: 1 Blue Ribbon Award, 1 Hochi Film Award, 3 Japanese Academy Awards, 2 Mainichi Film Concours, 1 Palme d'Or",Japan
Onna goroshi abura no jigoku,1984,0,0,0,0,Television film,Japan
The Eight Diagram Cudgel Fighter,1985,980,980,980,0,a Hong Kong film about the Generals of the Yang Family legends,China
Ran,1985,0,0,0,0,Awards: 2 BAFTA Awards,Japan
Northanger Abbey,1986,late 1800  (1798),1798,1798,0,adaptation of Jane Austen's 1817 novel set during the time Miss Austen wrote the novel.,England
Lady Jane,1986,1553,1553,1553,0,"About Lady Jane Grey, Queen Regnant of the Kingdom of England for nine days.",England
The Name of the Rose,1986,1327,1327,1327,0,set in an Italian monastery,Italy
Gonza the Spearman,1986,0,0,0,0,Awards: 1 Silver Bear,Japan
Bakumatsu seishun graffiti: Ronin Sakamoto Ryoma,1986,0,0,0,0,Awards: 1 Hochi Film Award,Japan
Pathfinder,1987,900,900,900,0,Based on a Sami legend,Norway
The Deceivers,1988,1825,1825,1825,0,British officer in India investigates the Thugee cult,India
The Deceivers,1988,1825,1825,1825,0,About Thugees in India in 1825,India
Time of Violence,1988,1668,1668,1668,0,Bulgarian Christian region is selected by the Ottoman rulers to serve as an example of conversion to Islam,Bulgaria
Stealing Heaven,1988,1120,1120,1120,0,Peter Abelard and Héloïse,France
The Silk Road,1988,1026,1026,1026,0,a Japanese film about Western Xia,China
In the Shadow of the Raven,1988,900,900,900,0,Set in the Viking Age,Iceland
Lonesome Dove,1989,1870,1870,1870,0,the closing years of the Old West,Moody Ranch
Boj na Kosovu,1989,1389,1389,1389,0,a battle between Medieval Serbia and the Ottoman Empire,Serbia
Shogun's Shadow,1989,0,0,0,0,,Japan
Rikyu,1989,0,0,0,0,,Japan
Death of a Tea Master,1989,0,0,0,0,"Awards: 1 Japanese Academy Award, 1 Kinema Junpo Award, 1 Nikkan Sports Film Award, 1 Silver Hugo, 1 Silver Lion",Japan
Quigley Down Under,1990,1874,1874,1874,0,"A Sharpshooter from Wyoming is hired by an Australian rancher paying a very high price. But when Quigley arrives Down Under, all is not as it seems.",Australia
Treasure Island,1990,1750,1750,1750,0,Adaptation of the famous pirate story by Robert Louis Stevenson,Nassau
King of the Wind,1990,1727,1727,1727,0,"Depicts the life of the Godolphin Arabian, an Arabian colt in 18th-century Kingdom of Great Britain during the reign of George II of Great Britain.",England
Heaven and Earth,1990,0,0,0,0,,Japan
Thousand Pieces of Gold,1991,1880,1880,1880,0,Chinese immigrant woman in the American Old West.,Idaho
Tous les matins du monde,1991,late 1700 ,1790,1790,0,French composer Monsieur de Sainte-Colombe.,France
Young Catherine,1991,1744,1744,1744,0,Catherine II of Russia,Russia
Black Robe,1991,1634,1634,1634,0,Jesuit missionary among the Hurons.,wendake
Robin Hood: Prince of Thieves,1991,1190,1190,1190,0,During the life of Richard the Lionheart after his release from captivity in 1194,England
White Viking,1991,900,900,900,0,Set in the Viking Age,Iceland
Sengoku Ransei no Abarenbo Saito Dosan Doto no Tenka Tori,1991,0,0,0,0,Television film,Japan
Bakumatsu Jyunjyoden,1991,0,0,0,0,,Japan
Mangetsu: Mr. Moonlight,1991,0,0,0,0,Time Travel film.,Japan
The Last of the Mohicans,1992,1757,1757,1757,0,French and Indian War,Quebec
King Mindaugas (Valdžia),1992,1263,1263,1263,0,"Two-part psychological costume drama about the life of Lithuanian king Mindaugas based on a play by Latvian playwright M?rti?š Z?verts, aired by Lithuania's national broadcaster.",Lithuania
G?-hime,1992,0,0,0,0,Awards: 2 Japanese Academy Awards,Japan
The Oil-Hell Murder,1992,0,0,0,0,,Japan
Geronimo: An American Legend,1993,1886,1886,1886,0,"Events leading up to the capture of Geronimo, a prominent Apache leader during the Apache Wars.",Arizona
Gettysburg,1993,1863,1863,1863,0,The Battle of Gettysburg in the American Civil War,Gettysburg
Anchoress,1993,1325,1325,1325,0,An anchorite,France
Ihen kaid?,1993,0,0,0,0,Television film,Japan
Kaettekite Kogarashi Monjiro,1993,0,0,0,0,,Japan
Immortal Beloved,1994,1827,1827,1827,0,aftermath of the death of Beethoven,Germany
The Madness of King George,1994,1788,1788,1788,0,"The deteriorating mental health of George III of the United Kingdom, King of Great Britain and Ireland",UK
La Reine Margot,1994,1572,1572,1572,0,France during the St. Bartholomew's Day massacre. The massacre was part of the French Wars of Religion.,France
Prince of Jutland,1994,600,600,600,0,Denmark in the Germanic Heroic Age – legend of Amleth from the Danish Gesta Danorum,Denmark
Crest of Betrayal,1994,0,0,0,0,,Japan
47 Ronin,1994,0,0,0,0,,Japan
Jacob,1994,2000 BC (according to 00e Hebrew calendar),-2000,-2000,0,A German/Italian/American television film based on the novel Giacobbe by Francesco Maria Nappi. The novel is in turn based on the depiction of the patriarch Jacob in the Book of Genesis.,Damascus
Wild Bill,1995,1876,1876,1876,0,The last days of legendary lawman Wild Bill Hickok,Western US
The Horseman on the Roof,1995,1832,1832,1832,0,Second cholera pandemic in July Monarchy France,France
Persuasion,1995,early 1900 ,1817,1817,0,adaptation of Jane Austen's 1817 novel set during the Regency era in Great Britain,UK
Pride and Prejudice,1995,early 1900 ,1813,1813,0,adaptation of Jane Austen's 1813 novel set during the Regency era in Great Britain,UK
Sense and Sensibility,1995,early 1900 ,1811,1811,0,adaptation of Jane Austen's 1811 novel set during the Regency era in Great Britain,UK
Rob Roy,1995,1713,1713,1713,0,Scottish folk hero Robert Roy MacGregor,Scotland
Cutthroat Island,1995,1668,1668,1668,0,A female pirate and her companion race against their rivals to find a hidden island that contains a fabulous treasure.,Jamaica
The Viking Sagas,1995,"late 1000, early 11th centurie",1100,1100,0,"Borrows elements from several Icelandic sagas, most notably Laxdœla saga and Njáls saga",Iceland
Sharaku,1995,0,0,0,0,,Japan
Never Shall we Be Enslave!,1996,1885,1885,1885,0,A two-part film depicting the events of the Third Anglo-Burmese War and the fall of Thibaw Min and his Dynasty.,Burma
Emma,1996,early 1900 ,1815,1815,0,adaptation of Jane Austen's 1815 novel set during the Regency era in Great Britain,UK
Emma,1996,early 1900 ,1815,1815,0,adaptation of Jane Austen's 1815 novel set during the Regency era in Great Britain,UK
The Conquest,1996,896,896,896,0,About the Magyar settlement in Hungary,Hungary
Bungo torimono ezu - Harikomi,1996,0,0,0,0,Television film,Japan
Reborn From Hell: Samurai Armageddon,1996,0,0,0,0,Remake of the 1981 film Samurai Reincarnation.,Japan
Legend of the Devil,1996,0,0,0,0,,Japan
Tirad Pass: The Story of Gen. Gregorio del Pilar,1997,"December 2, 1899",1899,1899,0,"About the Battle of Tirad Pass, Philippine Campaign Against Americans led by General Gregorio Del Pilar.",Philippines
The Prince of Homburg,1997,1675,1675,1675,0,"Adaptation of the Heinrich von Kleist play fictionalizing the deeds of Frederick II, Landgrave of Hesse-Homburg in the Battle of Fehrbellin against Sweden. The Battle was part of the Scanian War.",Sweden
Barbara,1997,1640,1640,1640,0,"Set in Faroe Islands. About a love triangle between the pastor for the parish of Vágar, his unfaithful wife, and her foppish lover.",Faroe Islands
Eye of the Eagle,1997,1218,1218,1218,0,Adventure film about the prince of Denmark stopping a conspiracy to seize the crown,Denmark
Ivanhoe,1997,1192,1192,1192,0,adaptation of the novel by Sir Walter Scott about the English knight who returns from the Third Crusade to find that his name has been falsely slandered,England
The Journey to Xixia Empire,1997,1087,1087,1087,0,a Chinese film about Western Xia (Xixia),China
Roar,1997,400,400,400,0,Ireland – Celtic warriors attempt to repel a fictitious Roman invasion,Ireland
The Red Violin,1998,1681,1681,1681,0,One section of the film is set in 1681 in Cremona,Cremona
Shakespeare in Love,1998,1593,1593,1593,0,Fictional love affair involving playwright William Shakespeare and Viola de Lesseps while Shakespeare was writing Romeo and Juliet.,England
The Other Conquest,1998,1521,1521,1521,0,"Mexico, depicting the secret adherence to traditional religious beliefs of the converted Aztec survivors.",Mexico
Samurai Fiction: Episode One,1998,0,0,0,0,"Awards: 1 Mainichi Film Concours, 1 Puchon International Fantastic Film Festival Award, 2 Sitges Awards",Japan
"Kunoichi ninp?-ch?: Yagy? gaiden, Edo-bana jigoku-hen",1998,0,0,0,0,,Japan
The Emperor and the Assassin,1998,227 BC,-227,-227,0,based on the assassination attempt by Jing Ke on Qin Shi Huang,China
Mansfield Park,1999,early 1900 ,1814,1814,0,adaptation of Jane Austen's 1814 novel set during the Regency era in Great Britain,UK
Sleepy Hollow,1999,1799,1799,1799,0,"Set in the years after the American Revolution, when a Headless Horseman haunted a little town, Sleepy Hollow, New York.",New York
Plunkett & Macleane,1999,1748,1748,1748,0,Loosely based on The Gentlemen Highwaymen William Plunkett and Captain James MacLaine. They were highwaymen noted for their restrained and courteous behavior towards their victims.,Plunketts Creek
The 13th Warrior,1999,922,922,922,0,"blends elements of the historical account of the travels of Ahmad ibn Fadlan (AD 922), the legend of Beowulf (6th century), and the Kurosawa film Seven Samurai",Kiev
After the Rain,1999,0,0,0,0,,Japan
Owls' Castle,1999,0,0,0,0,Based on the novel under the same name.,Japan
Gohatto,1999,0,0,0,0,,Japan
The Crossing,2000,1776,1776,1776,0,George Washington's crossing of the Delaware River and the Battle of Trenton,Trenton
Vatel,2000,1671,1671,1671,0,France during the life of master chef François Vatel,France
Dora-Heita,2000,0,0,0,0,,Japan
Gojoe,2000,0,0,0,0,Awards: 1 Hochi Film Award,Japan
Lagaan,2001,1893,1893,1893,0,"A fictional account of a cricket game between the villagers of Champaner and the local British cantonment played in an effort to cancel the ""lagaan"" (a grain tax levied by the colonial authorities in India).",India
The Affair of the Necklace,2001,1780,1780,1780,0,"Based on the Affair of the Diamond Necklace. Jeanne of Valois-Saint-Rémy, a descendant of the House of Valois and courtesan takes revenge by scamming Marie Antoinette, Cardinal de Rohan, and others. The scandal kindling the flames of the French Revolution.",France
Musa (film),2001,1375,1375,1375,0,A story about diplomatic mission from the Goryeo travels to Ming China.,Korea
A Knight's Tale,2001,1356,1356,1356,0,"loose adaptation of The Knight's Tale by Geoffrey Chaucer, this tale is partially inspired by the exploits of William Marshall, but set in the 1350s (with mention made to Edward, the Black Prince and the Battle of Poitiers (1356))",England
Knights of the Quest,2001,1271,1271,1271,0,French knights journey to Greece to retrieve the Shroud of Turin,Europe
The Mists of Avalon,2001,late 500 - early 6th centurie,600,600,0,heavily fictionalized story of King Arthur,UK
Onmyoji,2001,0,0,0,0,,Japan
Ch?shingura 1/47,2001,0,0,0,0,Television film. Remake of the 1932 film Ch?shingura - Zempen: Akahoky? no maki.,Japan
Daniel Deronda,2002,1870,1870,1870,0,based on George Eliot's 1876 novel,England
Kewaishi,2002,0,0,0,0,Awards: 1 Tokyo International Film Festival Award,Japan
Kumamoto Stories,2002,0,0,0,0,"Includes 3 short films: Onna Kunishuu Ikki, Kikuchi-jo Monogatari: Sakimori-tachi no Uta, and Zuiketsu Genso: Tonkararin Yume Densetsu.",Japan
The Sea Is Watching,2002,0,0,0,0,,Japan
"Ryoma's Wife, Her Husband and Her Lover",2002,0,0,0,0,Awards: 1 Nikkan Sports Film Award,Japan
Sabu,2002,0,0,0,0,Television film,Japan
The Twilight Samurai,2002,0,0,0,0,Awards: 12 Japanese Academy Awards,Japan
Hero,2002,227 BC,-227,-227,0,based on the assassination attempt by Jing Ke on Qin Shi Huang,China
The Last Samurai,2003,1877,1877,1877,0,Fictional story based around the Satsuma Rebellion during the Meiji period.,Japan
Eroica,2003,1804,1804,1804,0,first performance of Beethoven's third symphony,Germany
Mein Name ist Bach,2003,1747,1747,1747,0,"Depicts Johann Sebastian Bach's visit to Frederick the Great in Potsdam, Prussia, when The Musical Offering was composed.",Germany
Horseman,2003,1747,1747,1747,0,"Set in the borders between the regions of Bosnia and Dalmatia, the crossroads of the Ottoman Empire and the Republic of Venice. It deals with issues relating to the region's native Croats as they struggle to live between two empires and two faiths: Catholicism and Islam. Also covers the possibility of a love affair between a Christian soldier and a Muslim noblewoman.",Germany
Sword in the Moon,2003,ca. 1600,1600,1600,0,Set during the beginning of the 17th century.,Korea
The Reckoning,2003,1380,1380,1380,0,"A priest on the lam takes up with a traveling band of actors, who then discover a murder has occurred and try to solve it by recreating the crime in a play.",England
The Lion in Winter,2003,1183,1183,1183,0,Henry II is in power as his wife Eleanor of Aquitaine plots with their sons,England
An Ancient Tale: When the Sun Was a God,2003,800,800,800,0,The death of Popiel and the rise of Piast the Wheelwright,Poland
Warriors of Heaven and Earth,2003,700,700,700,0,an action-adventure film set in Xinjiang,China
Once Upon a Time in a Battlefield,2003,660,660,660,0,Set during the Battle of Hwangsanbeol.,Korea
Pompeii: The Last Day,2003,79,79,79,0,Docu-drama that tells of the eruption of Mount Vesuvius on August 24 79 AD,Pompeii
Boudica,2003,60,60,60,0,Britain – a rebellion shortly after the area had been conquered by Rome,UK
When the Last Sword Is Drawn,2003,0,0,0,0,,Japan
Aragami,2003,0,0,0,0,Awards: 1 Silver Raven,Japan
Makai Tensh?,2003,0,0,0,0,,Japan
Azumi,2003,0,0,0,0,Based on the manga series of the same name.,Japan
Zat?ichi,2003,0,0,0,0,,Japan
Onmyoji 2,2003,0,0,0,0,,Japan
The Alamo,2004,1836,1836,1836,0,Battle of the Alamo during the Texas Revolution.,San Antonio
The Remains of Nothing,2004,1799,1799,1799,0,Eleonora Fonseca Pimentel,Italy
The Merchant of Venice,2004,1596,1596,1596,0,Set in the Republic of Venice. The film focuses on the Venetian Ghetto.,Venice
House of Flying Daggers,2004,859,859,859,0,Set during the end of the Tang dynasty,China
Ring of the Nibelungs,2004,450,450,450,0,about the Germanic hero Siegfried,Germany
The Voyage Home,2004,415,415,415,0,Rome – loosely based on the 5th-century poem De reditu suo by Rutilius Claudius Namatianus,Rome
The Passion of the Christ,2004,33 AD,33,33,0,Judea – The final 12 hours of Jesus Christ's life,Jerusalem
Warau Iemon,2004,0,0,0,0,"Awards: 2 Asia-Pacific Film Festival Awards, 1 Nikkan Sports Film Award",Japan
Kibakichi,2004,0,0,0,0,,Japan
Kibakichi 2,2004,0,0,0,0,,Japan
Izo,2004,0,0,0,0,,Japan
The Hidden Blade,2004,0,0,0,0,,Japan
Mangal Pandey: The Rising,2005,1857,1857,1857,0,About Mangal Pandey and the Sepoy Mutiny of 1857.,India
Bleak House,2005,1830,1830,1830,0,based on Charles Dickens' 1852–1853 novel,England
Pride and Prejudice,2005,early 1900 ,1813,1813,0,adaptation of Jane Austen's 1813 novel set during the Regency era in Great Britain,UK
The Headsman,2005,1525,1525,1525,0,An executioner in Tyrol (part of the Holy Roman Empire).,London
Soldier of God,2005,1187,1187,1187,0,a Templar who has survived the Battle of Hattin,Jurusalem
Beowulf & Grendel,2005,600,600,600,0,Denmark in the Germanic Heroic Age – loose adaptation of the Anglo-Saxon poem of Beowulf,Denmark
Azumi 2: Death or Love,2005,0,0,0,0,Based on the manga series of the same name.,Japan
Ashura,2005,0,0,0,0,"Awards: 1 Hochi Film Award, 1 Kinema Junpo Award, 1 Nikkan Sports Film Award, 1 Yokohama Film Festival Award",Japan
Samurai Commando: Mission 1549,2005,0,0,0,0,Awards: 1 Asia-Pacific Film Festival Award,Japan
Empire,2005,44 BC,-44,-44,0,Covers the struggle of a young Octavius to become the first emperor of Rome.,Rome
The Prestige,2006,1890,1890,1890,0,rival stage magicians in Victorian London,London
The Illusionist,2006,1889,1889,1889,0,tells the story of a magician in turn-of-the-century Vienna,Vienna
Copying Beethoven,2006,1824,1824,1824,0,final years of Ludwig van Beethoven,Germany
Napoleon and Me,2006,1814,1814,1814,0,Principality of Elba during the Napoleonic Wars,Elba
Nomad,2006,1810,1810,1810,0,"about the early years of Ablai Khan (early 18th century), a Kazakh khan in part of what is now Kazakhstan.",Kazakhstan
The Amazing Grace,2006,1748,1748,1748,0,"Tells the story of John Newton's transformation from slave trader to Anglican priest; story is set in Calabar, Nigeria.",Nigeria
Blackbeard,2006,1718,1718,1718,0,the infamous pirate Edward Teach,Nassau
Alatriste,2006,1643,1643,1643,0,Life of a Spanish soldier (Capitaine Alatriste) until the Battle of Rocroi. Based on the novel by Arturo Perez-Reverte,Spain
Apocalypto,2006,1502,1502,1502,0,"Yucatán Peninsula, Mexico, the declining period of the Maya civilization.",Mexico
Curse of the Golden Flower,2006,928,928,928,0,Set during the Later Tang Dynasty,China
Tristan & Isolde,2006,600,600,600,0,Britain and Ireland – adaptation of the Brythonic legend of Tristan and Iseult,Ireland
The Inquiry,2006,37,37,37,0,Roman province of Judea shortly after the death of Jesus,Jerusalem
Hana,2006,0,0,0,0,Awards: 1 Nikkan Sports Film Award,Japan
Love and Honor,2006,0,0,0,0,,Japan
The Nativity Story,2006,4 BC,-4,-4,0,"Judea – The Biblical account of the nativity of Jesus, following the story of Mary and Joseph until the birth of Jesus occurs.",bethlehem
Bury My Heart at Wounded Knee,2007,1890,1890,1890,0,Wounded Knee massacre,Pine Ridge Reservation
Persuasion,2007,early 1900 ,1817,1817,0,adaptation of Jane Austen's 1817 novel set during the Regency era in Great Britain,UK
Northanger Abbey,2007,early 1900 ,1817,1817,0,adaptation of Jane Austen's 1817 novel set during the Regency era in Great Britain,UK
Mansfield Park,2007,early 1900 ,1814,1814,0,adaptation of Jane Austen's 1814 novel set during the Regency era in Great Britain,UK
The Sovereign's Servant,2007,1709,1709,1709,0,The Battle of Poltava during the Great Northern War.,Russia
Molière,2007,1645,1645,1645,0,The French playwright Molière,France
1612,2007,1612,1612,1612,0,The Tsardom of Russia during the Time of Troubles,Russia
Shadows in the Palace,2007,1600,1600,1600,0,Set during the 17th century.,Korea
Grendel,2007,600,600,600,0,Denmark in the Germanic Heroic Age – very loose adaptation of the Anglo-Saxon poem of Beowulf,Denmark
Beowulf,2007,600,600,600,0,Denmark in the Germanic Heroic Age – loose adaptation of the Anglo-Saxon poem of Beowulf,Denmark
Kaidan,2007,0,0,0,0,Awards: 1 Yokohama Film Festival Award,Japan
Sukiyaki Western Django,2007,0,0,0,0,,Japan
Chacha,2007,0,0,0,0,,Japan
300,2007,480 BC,-480,-480,0,"Greece: Battle of Thermopylae, Greece","Thermopylae, Greece"
Baler,2008,1898,1898,1898,0,During the Siege of Baler.,Philippines
Sense and Sensibility,2008,early 1900 ,1811,1811,0,adaptation of Jane Austen's 1811 novel set during the Regency era in Great Britain,UK
Charlotte Corday,2008,1793,1793,1793,0,Trial and execution of Charlotte Corday after her murder of Jean-Paul Marat. Marat was a Jacobin journalist and politician.,France
A Viking Saga,2008,870,870,870,0,The Rus prince Oleg of Novgorod defeats Askold and Dir,Russia
Outlander,2008,709,709,709,0,"Loosely based on the 9th-century epic poem Beowulf, adapted to a science-fiction backstory involving a spaceship crashing in Iron Age Norway",Denmark
An Empress and the Warriors,2008,ca. 350,350,350,0,set in the Former Yan during the Sixteen Kingdoms period,China
Three Kingdoms: Resurrection of the Dragon,2008,229,229,229,0,"a Hong Kong film about Zhao Yun, loosely based on parts of the novel Romance of the Three Kingdoms",China
Yamazakura,2008,0,0,0,0,,Japan
Geisha Assassin,2008,0,0,0,0,,Japan
Ichi,2008,0,0,0,0,,Japan
"10,000 BC",2008,"10,000 BC",-10000,-10000,0,Set in the prehistoric era (12 000 years ago) and depicts the journeys of a prehistoric tribe of mammoth hunters.,Europe
Emma,2009,early 1900 ,1815,1815,0,adaptation of Jane Austen's 1815 novel set during the Regency era in Great Britain,UK
The Sword with No Name,2009,1800,1800,1800,0,Set during the 19th century.,Korea
Journey to Mecca,2009,1325,1325,1325,0,A dramatised documentary film charting the first real-life journey made by the Islamic scholar Ibn Battuta from his native Morocco to Mecca for the Hajj,Saudi Arabia
Barbarossa,2009,1176,1176,1176,0,Battle of Legnano,Northern Italy
Didgori: Land of Sacrificed Knights,2009,1121,1121,1121,0,"Battle of Didgori, in which Georgia's king David IV defeated the Seljuks",Tbilisi
1066 The Battle for Middle Earth,2009,1066,1066,1066,0,During the Norman conquest,England
Severed Ways,2009,1007,1007,1007,0,Two Denmarkns left behind in North America after the settlements made by Leif Ericson were abandoned,North America
Valhalla Rising,2009,1000,1000,1000,0,Follows a Norse warrior named One-Eye and a boy as they travel with a band of Christian Crusaders by ship in the hopes of finding the Holy Land.,North America
Samurai Avenger: The Blind Wolf,2009,0,0,0,0,,Japan
Ballad: Na mo naki koi no uta,2009,0,0,0,0,,Japan
Castle Under Fiery Skies,2009,0,0,0,0,,Japan
Wheat,2009,260 BC,-260,-260,0,the story of women left behind when their husbands went to war during the Battle of Changping,China
Veer,2010,1825,1825,1825,0,"Set during the 1825 Pindari movement of Rajasthan, when India was ruled by the East India Company",India
Mozart's Sister,2010,1763,1763,1763,0,"The early life of Maria Anna Mozart, older sister of Wolfgang Amadeus Mozart.",Austria
The Princess of Montpensier,2010,1572,1572,1572,0,France during the St. Bartholomew's Day massacre. The massacre was part of the French Wars of Religion.,France
Blades of Blood,2010,1500,1500,1500,0,Set during the 16th century.,Korea
Black Death,2010,1348,1348,1348,0,During the initial outbreak of the plague,England
Robin Hood,2010,1199,1199,1199,0,from the death of Richard the Lionheart until the early reign of King John,England
Centurion,2010,117,117,117,0,Roman Britain – the supposed fate of the Ninth Legion,UK
Sword of Desperation,2010,0,0,0,0,,Japan
13 Assassins,2010,0,0,0,0,Remake of the 1963 film 13 Assassins.,Japan
?oku,2010,0,0,0,0,Based on the manga series of the same name.,Japan
The Sakurada Gate Incident,2010,0,0,0,0,,Japan
Abacus and Sword,2010,0,0,0,0,,Japan
Yamada: The Samurai of Ayothaya,2010,0,0,0,0,Awards: 1 Thailand National Film Association Award,Japan
The Winter Butterfly,2010,0,0,0,0,,Japan
The Conspirator,2011,April 1865,1865,1865,0,Based on the events of the aftermath of the assassination of Abraham Lincoln.,"Washington, DC"
The Mill and the Cross,2011,1564,1564,1564,0,Life in Flanders under Spanish Habsburg rule as depicted in Pieter Bruegel the Elder's 1564 painting The Procession to Calvary.,Spain
Urumi,2011,1500,1500,1500,0,Historical fiction on Portuguese colonial rule in Malabar,Calicut
Blood Letter,2011,c. 1442,1442,1442,0,About the retaliation of Tran Nguyen Vu (Nguyen Trai's grandchild) for his grandfather death in 1442. The movie was based on Bui Anh Tan's bestselling of the same name.,Vietnam
Ironclad,2011,1215,1215,1215,0,the siege of Rochester Castle,England
Legendary Amazons,2011,1030,1030,1030,0,a Chinese film about the Genearals of the Yang Family legends,China
The Lost Bladesman,2011,219,219,219,0,a Hong Kong film loosely based on the story of Guan Yu (d. 219) in the novel Romance of the Three Kingdoms,China
The Eagle,2011,140,140,140,0,Roman Britain – a young Roman man attempts to find out what happened to his father and the Ninth Legion,UK
At River's Edge,2011,0,0,0,0,,Japan
Scabbard Samurai,2011,0,0,0,0,,Japan
Hara-Kiri: Death of a Samurai,2011,0,0,0,0,Remake of the 1962 film Harakiri.,Japan
Mahindagamanaya,2011,250 BC,-250,-250,0,based on arrival of Buddhism to Sri Lanka,Sri Lanka
The Warring States,2011,ca. 316 BC,-316,-316,0,"set in the Warring States period (475–221 BC), loosely based on the rivalry between Sun Bin (d. 316 BC) and Pang Juan (d. 342 BC)",China
Immortals,2011,1228 BC,-1228,-1228,0,Loosely based on the Greek myth of Theseus and the Minotaur and the Titanomachy.,Athens
"Atlantis: End of a World, Birth of a Legend",2011,1600 BC,-1600,-1600,0,"Docudrama which depicts a re-enactment of the events surrounding the Minoan eruption, a major catastrophic volcanic eruption in the island of Thera (modern Santorini). The historical eruption devastated the island, and communities and agricultural areas on nearby islands and Crete. The event is thought to be connected to a decline and eventual downfall for the Minoan civilization, an incident believed to have inspired the legend of Atlantis.",Santorini
Lincoln,2012,Early 1865,1865,1865,0,Events chronicling the last few months of the life of President of the United States Abraham Lincoln.,"Washington, DC"
"Farewell, My Queen",2012,1789,1789,1789,0,"Marie Antoinette, Queen consort of France",France
The Day of the Siege: September Eleven 1683,2012,1683,1683,1683,0,Second ottoman siege of Vienna.,Vienna
The Floating Castle,2012,Late 1600 ,1600,1600,0,"Set in feudal Japan, the film is based on the Siege of Oshi and depicts the struggle of Oshi's villagers in defending their fortress against Toyotomi Hideyoshi's campaign against the Hojo clan.",Japan
Katherine of Alexandria,2012,307,307,307,0,Roman province of Egypt shortly before the legalization of Christianity,Rome
Siri Daladagamanaya,2012,300,300,300,0,based on venerated of Tooth relic to Sri Lanka,Sri Lanka
The Assassins,2012,210,210,210,0,The film is set in China in the late 210s – the years preceding the end of the Han dynasty,China
Shinobido,2012,0,0,0,0,,Japan
The Dry Blade,2012,0,0,0,0,,Japan
Rurouni Kenshin,2012,0,0,0,0,Based on the manga series of the same name.,Japan
The Lone Ranger,2013,1869,1869,1869,0,The Lone Ranger and his sidekick Tonto bring justice to the wild west.,Utah
A Field in England,2013,1640,1640,1640,0,During the English Civil War,England
The Physician,2013,1100,1100,1100,0,An adventure film based on the novel of the same name by Noah Gordon.,Iran
Saving General Yang,2013,980,980,980,0,a Hong Kong film about the Generals of the Yang Family legends,China
Unforgiven,2013,0,0,0,0,Based on the 1992 American western of the same name.,Japan
The Book of Daniel,2013,605 BC,-605,-605,0,"In 605 B.C. Jerusalem was conquered by the Babylonians and many of their best young men were taken into captivity, including Daniel.","Jerusalem, Israel"
A Little Chaos,2014,1682,1682,1682,0,King Louis XIV of France and the design and construction of the Gardens of Versailles,Gardens of Versailles
The Admiral: Roaring Currents,2014,1597,1597,1597,0,Battle of Myeongnyang: naval battle between Japan and Korea.,Korea
Ironclad: Battle for Blood,2014,1221,1221,1221,0,"A survivor of the Great Siege of Rochester Castle fights to save his clan from Celtic raiders. A sequel to the 2011 film, Ironclad.",England
Mission Impossible: Samurai[4],2014,0,0,0,0,,Japan
Zakurozaka no Adauchi[5],2014,0,0,0,0,,Japan
Hercules,2014,358 BC,-358,-358,0,"An American action fantasy adventure film based on the graphic novel Hercules: The Thracian Wars, which presents a realistic and more human version of Hercules.",Thrace
300: Rise of an Empire,2014,480 BC,-480,-480,0,Greece: Battle of Salamis,Salamis
The Revenant,2015,1823,1823,1823,0,American frontiersman Hugh Glass fights for survival in the unincorporated Dakotas,Montanta
Versailles,2015,1660,1660,1660,0,Fictionalized drama about the reign of King Louis XIV of France and the building of Versailles,France
William the Conqueror,2015,1066,1066,1066,0,William the Conqueror when he is about to embark from Dives-sur-Mer to conquer England in the year 1066,France
Macbeth,2015,1050,1050,1050,0,Scottish king Mac Bethad mac Findlaích,Scotland
Kakekomi[6],2015,0,0,0,0,,Japan
Masterless,2015,0,0,0,0,,Japan
Risen,2016,33 AD,33,33,0,Judea – Immediately after Jesus' crucifixion,Jerusalem
Mohenjo Daro,2016,2016 BC,-2016,-2016,0,"Filmset in 2016 BC, in the ancient city of Mohenjo-daro. The historical city was one of the largest settlements of the Indus Valley Civilisation, and one of the world's earliest major cities.",Mohenjo-daro
Gods of Egypt,2016,3200 BC,-3200,-3200,0,"A fantasy action film based on the ancient Egyptian deities and story of god Horus (Horus may be shown as a falcon on the Narmer Palette, dating from about the 3300–3200 BC).",Egypt
Hostiles,2017,1892,1892,1892,0,A U.S. Cavalry officer who must escort a Cheyenne war chief and his family back to their home in Montana,Montana
Woman Walks Ahead,2017,1890,1890,1890,0,"the story of Catherine Weldon, a portrait painter who travels from New York to Dakota to paint a portrait of Sitting Bull",South Dakota
The Fortress,2017,1636,1636,1636,0,Set during the second Manchu invasion of Korea.,Korea
Sekigahara,2017,1600,1600,1600,0,Based on a novel by Ry?tar? Shiba about the Battle of Sekigahara.,Korea
The Gaelic King,2017,800,800,800,0,"Tells the story of warrior-king Alpin. When his young brother is captured, Alpin must hunt the kidnappers though a dark forest that hides an ancient evil.",Scotland
Gautamiputra Satakarni,2017,2nd ,150,150,0,about the achievements of Satavahana dynasty ruler Gautamiputra Satakarni of uniting various Indian kingdoms during the British Raj.,India
Peterloo,2018,1819,1819,1819,0,based on the Peterloo massacre of 1819,England
The Favourite,2018,1708,1708,1708,0,"A frail Queen Anne occupies the throne and her close friend, Lady Sarah, governs the country in her stead. When a new servant, Abigail, arrives, her charm endears her to Sarah.",England
Padmaavat,2018,1303,1303,1303,0,"Narrates a story about Padmavati, a legendary Rajput queen, and her kingdom's conflict with Delhi Sultan Alauddin Khilji",India
Robin Hood,2018,1190,1190,1190,0,During the life of Richard the Lionheart,England
The Great Battle,2018,645,645,645,0,Set during the Siege of Ansi.,Korea
Britannia,2018,43,43,43,0,"Set in AD 43, the series follows the Roman conquest of Britain",UK
Alpha,2018,"20,000 BC",-20000,-20000,0,Dog domestication,Europe
Panipat: The Great Betrayal,2019,1761,1761,1761,0,Based on the Third Battle of Panipat.,India
The Name of the Rose,2019,1327,1327,1327,0,Miniseries set in an Italian monastery. A dispute over the evangelical counsel of poverty between representatives of the Franciscan Order and the Avignon Papacy,Italy
The First King: Birth of an Empire,2019,753 BC,-753,-753,0,"Set in the 8th century BC, it is about the shepherd brothers Romulus and Remus and the founding of Rome.",Rome
Belgravia,2020,1840,1840,1840,0,British society during the early Victorian era,England
Emma,2020,early 1900 ,1815,1815,0,adaptation of Jane Austen's 1815 novel set during the Regency era in Great Britain,UK
Tanhaji: The Unsung Warrior,2020,1670,1670,1670,0,Biopic of Tanaji Malusare and centered around Maratha expedition of Kondhana also called Battle of Singhad.,"Godoli, Satara, India"
Barbarians,2020,9 AD,9,9,0,"Series is a fictional account of events during the Roman Empire's occupation of Germania, and the resulting rebellion of the Germanic tribes led by Arminius.",Germany
The Last Duel,2021,1390,1390,1390,0,Based on the book The Last Duel: A True Story of Trial by Combat in Medieval France by Eric Jager.,France
King Lear (many adaptations),1905,800 BC,-800,-800,0,Celtic Britain,UK
The Prince and the Pauper (many adaptations),1909,1547,1547,1547,0,"Mark Twain's novel, featuring a fictional portrayal of Edward VI of England.",England
Die Nibelungen,1966,450,450,450,0,"about the Germanic hero Siegfried, his murder, and his widow's vengeance",Germany
Arthur of the Britons,1972,500,500,500,0,Britain after the Roman withdrawal,Uk
Atlantis,2013,1600 BC,-1600,-1600,0,"Far from home, Jason washes up on the shores of the ancient and mysterious city of Atlantis.",
Romulus,2020,800 BC,-800,-800,0,"Set in the 8th century BC, narrates the events preceding the founding of Rome.",Rome
